அறம் ஒரு கருவி   	அரம் ஒரு கருவி   	RWE_M	0
அரம் என்றால் தருமம் 	அறம் என்றால் தருமம் 	RWE_M	0
புடலையை அறி	புடலையை அரி	RWE_M	1
அரிதல் என்றால் தெரிந்து கொள்ளுதல் 	அறிதல் என்றால் தெரிந்து கொள்ளுதல் 	RWE_M	0
அறுகு என்றால் அண்மை 	அருகு என்றால் அண்மை 	RWE_M	0
அருகு என்றால் அறுகம்புல் 	அறுகு என்றால் அறுகம்புல் 	RWE_M	0
அறை என்பதன் பொருள் பாதி	அரை என்பதன் பொருள் பாதி	RWE_M	0
எந்த அரையில் தங்கினாய்?	எந்த அறையில் தங்கினாய்?	RWE_M	1
இறத்தல் என்றால் பிச்சை எடுத்தல் 	இரத்தல் என்றால் பிச்சை எடுத்தல் 	RWE_M	0
இரத்தல் என்றால் சாதல் 	இறத்தல் என்றால் சாதல் 	RWE_M	0
உறவு என்றால் வலிமை 	உரவு என்றால் வலிமை 	RWE_M	0
உரவின்முறை 	உறவின்முறை 	RWE_M	0
தோலை உறி	தோலை உரி	RWE_M	1
கட்டித் தொங்க விடும் உரி 	கட்டித் தொங்க விடும் உறி	RWE_M	3
உறிஞ்சல் என்றால் உராய்தல் 	உரிஞ்சல் என்றால் உராய்தல் 	RWE_M	0
உரிஞ்சல் என்றால் உறிஞ்சிக் குடித்தல் 	உறிஞ்சல் என்றால் உறிஞ்சிக் குடித்தல் 	RWE_M	0
உறை என்றால் சொல்	உரை என்றால் சொல்	RWE_M	0
தலையணை உரை 	தலையணை உறை 	RWE_M	1
எறி என்றால் கொளுத்து 	எரி என்றால் கொளுத்து 	RWE_M	0
எரி என்றால் தூக்கி வீசு 	எறி என்றால் தூக்கி வீசு 	RWE_M	0
கற என்றால் மறை 	கர என்றால் மறை 	RWE_M	0
பால் கர 	பால் கற 	RWE_M	1
குளத்தின் கறை 	குளத்தின் கரை 	RWE_M	1
துணியில் கரை உள்ளது 	துணியில் கறை உள்ளது 	RWE_M	1
குறங்கு தாவியது 	குரங்கு தாவியது 	RWE_M	0
குரங்கு என்றால் தொடை 	குறங்கு என்றால் தொடை 	RWE_M	0
குறவை ஒரு வகைக் கூத்து 	குரவை ஒரு வகைக் கூத்து 	RWE_M	0
குரவை ஒரு வகை மீன் 	குறவை ஒரு வகை மீன் 	RWE_M	0
நாய் குறைத்தது 	நாய் குரைத்தது 	RWE_M	1
எடை குரைந்தது 	எடை குறைந்தது 	RWE_M	1
வீட்டின் கூறை	வீட்டின் கூரை 	RWE_M	1
கூரை என்றால் துணி 	கூறை என்றால் துணி 	RWE_M	0
செறித்தல் என்றால் செரிமானம் ஆதல் 	செரித்தல் என்றால் செரிமானம் ஆதல் 	RWE_M	0
செரித்தல் என்றால் திணித்தல் 	செறித்தல் என்றால் திணித்தல் 	RWE_M	0
பூச்சொறி	பூச்சொரி	RWE_M	0
காலைச் சொரியாதே!  	காலைச் சொறியாதே!  	RWE_M	1
திறை என்றால் அலை 	திரை என்றால் அலை 	RWE_M	0
திரை என்றால் வரி 	திறை என்றால் வரி 	RWE_M	0
தலைமுடி நறைத்தது 	தலைமுடி நரைத்தது 	RWE_M	1
நரை என்றால் தேன் 	நறை என்றால் தேன் 	RWE_M	0
நிறை என்றால் வரிசை 	நிரை என்றால் வரிசை 	RWE_M	0
பானையை நீரால் நிரைத்து விடு	பானையை நீரால் நிறைத்து விடு	RWE_M	2
பறவை என்றால் கடல் 	பரவை என்றால் கடல் 	RWE_M	0
குயில் ஒரு பரவை 	குயில் ஒரு பறவை 	RWE_M	2
பறி என்றால் குதிரை 	பரி என்றால் குதிரை 	RWE_M	0
பரித்தல் என்றால் பிடுங்கிக் கொள்ளுதல் 	பறித்தல் என்றால் பிடுங்கிக் கொள்ளுதல் 	RWE_M	0
கடப்பாறை எடு 	கடப்பாரை எடு 	RWE_M	0
பாரை மேல் அமர்ந்தான் 	பாறை மேல் அமர்ந்தான் 	RWE_M	0
பிரை நிலா 	பிறை நிலா 	RWE_M	0
பிறை என்றால் உறைமோர் 	பிரை என்றால் உறைமோர் 	RWE_M	0
சோளப் பொறி 	சோளப் பொரி 	RWE_M	1
பொரி என்றால் இயந்திரம் 	பொறி என்றால் இயந்திரம் 	RWE_M	0
காசைப் பொருக்கினான் 	காசைப் பொறுக்கினான் 	RWE_M	1
பொறுக்கு என்றால் பருக்கை 	பொருக்கு என்றால் பருக்கை 	RWE_M	0
மரம் என்றால் வீரம் 	மறம் என்றால் வீரம் 	RWE_M	0
மரம் என்றால் பாவம்  	மறம் என்றால் பாவம்  	RWE_M	0
பனை மறம்  	பனை மரம்  	RWE_M	1
மறி என்றால் சாகாமை 	மரி என்றால் சாகாமை 	RWE_M	0
சாலை மரியல் 	சாலை மறியல் 	RWE_M	1
மறை என்றால் மான் 	மரை என்றால் மான் 	RWE_M	0
உண்மையை மரைத்தான் 	உண்மையை மறைத்தான் 	RWE_M	1
முறுக்கு ஒரு மரம் 	முருக்கு ஒரு மரம் 	RWE_M	0
மீசையை முருக்கு 	மீசையை முறுக்கு 	RWE_M	1
விறகு என்றால் தந்திரம் 	விரகு என்றால் தந்திரம் 	RWE_M	0
விரகுக் கட்டை 	விறகுக் கட்டை 	RWE_M	0
விரல் என்றால் வெற்றி என்று பொருள் 	விறல் என்றால் வெற்றி என்று பொருள் 	RWE_M	0
கையில் விறல்கள் உள்ளன 	கையில் விரல்கள் உள்ளன 	RWE_M	1
அழகு என்பது அளவு 	அலகு என்பது அளவு 	RWE_M	0
அளகு என்பது அளவு 	அலகு என்பது அளவு 	RWE_M	0
அலகு ஒரு பறவை 	அளகு ஒரு பறவை 	RWE_M	0
அழகு ஒரு பறவை 	அளகு ஒரு பறவை 	RWE_M	0
வானவில் அலகாக இருந்தது 	வானவில் அழகாக இருந்தது 	RWE_M	1
வானவில் அளகாக இருந்தது 	வானவில் அழகாக இருந்தது 	RWE_M	1
பரிசு அலித்தான் 	பரிசு அளித்தான் 	RWE_M	1
பரிசு அழித்தான் 	பரிசு அளித்தான் 	RWE_M	1
கொன்று அலித்தான் 	கொன்று அழித்தான் 	RWE_M	1
கொன்று அளித்தான் 	கொன்று அழித்தான் 	RWE_M	1
முகமது அழி 	முகமது அலி 	RWE_M	1
முகமது அளி 	முகமது அலி 	RWE_M	1
அளைகடல் 	அலைகடல் 	RWE_M	0
அழைகடல் 	அலைகடல் 	RWE_M	0
தொலைபேசியில் அளைத்தான் 	தொலைபேசியில் அழைத்தான் 	RWE_M	1
தொலைபேசியில் அலைத்தான் 	தொலைபேசியில் அழைத்தான் 	RWE_M	1
அலை என்றால் வளை என்று பொருள் 	அளை என்றால் வளை என்று பொருள் 	RWE_M	0
அழை என்றால் வளை என்று பொருள் 	அளை என்றால் வளை என்று பொருள் 	RWE_M	0
வேலை ஆல் 	வேலை ஆள் 	RWE_M	1
வேலை ஆழ் 	வேலை ஆள் 	RWE_M	1
ஆல் மனம் 	ஆழ் மனம் 	RWE_M	0
ஆள் மனம் 	ஆழ் மனம் 	RWE_M	0
ஆழ் கிளை	ஆல் கிளை	RWE_M	0
ஆள் கிளை	ஆல் கிளை	RWE_M	0
தாமரை இளை 	தாமரை இலை 	RWE_M	1
தாமரை இழை 	தாமரை இலை 	RWE_M	1
இலைத்தல் இகழ்ச்சி 	இளைத்தல் இகழ்ச்சி 	RWE_M	0
இழைத்தல் இகழ்ச்சி 	இளைத்தல் இகழ்ச்சி 	RWE_M	0
இலை என்பது மெல்லிய நூல் 	இழை என்பது மெல்லிய நூல் 	RWE_M	0
இளை என்பது மெல்லிய நூல் 	இழை என்பது மெல்லிய நூல் 	RWE_M	0
நிலத்தில் உலவு செய்யலாம் 	நிலத்தில் உழவு செய்யலாம் 	RWE_M	1
நிலத்தில் உளவு செய்யலாம் 	நிலத்தில் உழவு செய்யலாம் 	RWE_M	1
ஒற்றன் உலவு பார்த்தான் 	ஒற்றன் உளவு பார்த்தான் 	RWE_M	1
ஒற்றன் உழவு பார்த்தான் 	ஒற்றன் உளவு பார்த்தான் 	RWE_M	1
ஆற்றங்கரையில் உளவினேன் 	ஆற்றங்கரையில் உலவினேன் 	RWE_M	1
ஆற்றங்கரையில் உழவினேன் 	ஆற்றங்கரையில் உலவினேன் 	RWE_M	1
ஒளி என்றால் சத்தம் 	ஒலி என்றால் சத்தம் 	RWE_M	0
ஒழி என்றால் சத்தம் 	ஒலி என்றால் சத்தம் 	RWE_M	0
ஒலி என்றால் வெளிச்சம் 	ஒளி என்றால் வெளிச்சம் 	RWE_M	0
ஒழி என்றால் வெளிச்சம் 	ஒளி என்றால் வெளிச்சம் 	RWE_M	0
ஒலி  என்பது அழித்தல் 	ஒழி என்பது அழித்தல் 	RWE_M	0
ஒளி என்பது அழித்தல் 	ஒழி என்பது அழித்தல் 	RWE_M	0
களி என்றால் பஞ்சம் 	கலி என்றால் பஞ்சம் 	RWE_M	0
கழி என்றால் பஞ்சம் 	கலி என்றால் பஞ்சம் 	RWE_M	0
கலி என்பதன் பொருள்  மகிழ்தல் 	களி என்பதன் பொருள்  மகிழ்தல் 	RWE_M	0
கழி என்பதன் பொருள்  மகிழ்தல் 	களி என்பதன் பொருள்  மகிழ்தல் 	RWE_M	0
கலி என்றால் உப்பளம் 	கழி என்றால் உப்பளம் 	RWE_M	0
களி என்றால் உப்பளம் 	கழி என்றால் உப்பளம் 	RWE_M	0
களை என்பதன் பொருள் மூங்கில் 	கழை என்பதன் பொருள் மூங்கில் 	RWE_M	0
கலை என்பதன் பொருள் மூங்கில் 	கழை என்பதன் பொருள் மூங்கில் 	RWE_M	0
நடனக் களை	நடனக் கலை	RWE_M	1
நடனக் கழை	நடனக் கலை	RWE_M	1
கலை பறித்தாள் 	களை பறித்தாள் 	RWE_M	0
கழை பறித்தாள் 	களை பறித்தாள் 	RWE_M	0
கிலி ஒரு பறவை 	கிளி ஒரு பறவை 	RWE_M	0
கிழி ஒரு பறவை 	கிளி ஒரு பறவை 	RWE_M	0
தாளைக் கிலி 	தாளைக் கிழி 	RWE_M	1
தாளைக் கிளி 	தாளைக் கிழி 	RWE_M	1
கிளி என்பதன் பொருள் பயம் 	கிலி என்பதன் பொருள் பயம் 	RWE_M	0
கிழி என்பதன் பொருள் பயம் 	கிலி என்பதன் பொருள் பயம் 	RWE_M	0
படை சூலப் புறப்பட்டான் 	படை சூழப் புறப்பட்டான் 	RWE_M	1
படை சூளப் புறப்பட்டான் 	படை சூழப் புறப்பட்டான் 	RWE_M	1
சூல் என்பதன் பொருள் சபதம் 	சூள் என்பதன் பொருள் சபதம் 	RWE_M	0
சூழ் என்பதன் பொருள் சபதம் 	சூள் என்பதன் பொருள் சபதம் 	RWE_M	0
சூள் என்பதன் பொருள் கருப்பம் 	சூல் என்பதன் பொருள் கருப்பம் 	RWE_M	0
சூழ் என்பதன் பொருள் கருப்பம் 	சூல் என்பதன் பொருள் கருப்பம் 	RWE_M	0
தளையில் தொப்பி வைத்தான் 	தலையில் தொப்பி வைத்தான் 	RWE_M	0
தழையில் தொப்பி வைத்தான் 	தலையில் தொப்பி வைத்தான் 	RWE_M	0
தழை என்பதன் பொருள் கட்டு 	தளை என்பதன் பொருள் கட்டு 	RWE_M	0
தலை என்பதன் பொருள் கட்டு 	தளை என்பதன் பொருள் கட்டு 	RWE_M	0
தளை என்பதன் பொருள் தளிர் 	தழை என்பதன் பொருள் தளிர் 	RWE_M	0
தலை என்பதன் பொருள் தளிர் 	தழை என்பதன் பொருள் தளிர் 	RWE_M	0
வளியில் துடித்தாள் 	வலியில் துடித்தாள் 	RWE_M	0
வழியில் துடித்தாள் 	வலியில் துடித்தாள் 	RWE_M	0
வலி என்பதன் பொருள் காற்று 	வளி என்பதன் பொருள் காற்று 	RWE_M	0
வழி என்பதன் பொருள் காற்று 	வளி என்பதன் பொருள் காற்று 	RWE_M	0
கிராமம் செல்லும் வலி	கிராமம் செல்லும் வழி 	RWE_M	2
கிராமம் செல்லும் வளி 	கிராமம் செல்லும் வழி 	RWE_M	2
வளையில் மீன் சிக்கியது 	வலையில் மீன் சிக்கியது 	RWE_M	0
வழையில் மீன் சிக்கியது 	வலையில் மீன் சிக்கியது 	RWE_M	0
வளை ஒரு மரம் 	வழை ஒரு மரம் 	RWE_M	0
வலை ஒரு மரம் 	வழை ஒரு மரம் 	RWE_M	0
கண்ணாடி வலையல் 	கண்ணாடி வளையல் 	RWE_M	1
கண்ணாடி வழையல் 	கண்ணாடி வளையல் 	RWE_M	1
நாய் வாள்	நாய் வால்	RWE_M	1
நாய் வாழ்	நாய் வால்	RWE_M	1
நலமாக வால் 	நலமாக வாழ் 	RWE_M	1
நலமாக வாள் 	நலமாக வாழ் 	RWE_M	1
வால் கூர்மையாக இருந்தது 	வாள் கூர்மையாக இருந்தது 	RWE_M	0
வாழ் கூர்மையாக இருந்தது 	வாள் கூர்மையாக இருந்தது 	RWE_M	0
விலாக்காலம் 	விழாக்காலம் 	RWE_M	0
விளாக்காலம் 	விழாக்காலம் 	RWE_M	0
விலா ஒரு மரம் 	விளா ஒரு மரம் 	RWE_M	0
விழா ஒரு மரம் 	விளா ஒரு மரம் 	RWE_M	0
விழாவெலும்பு	விலாவெலும்பு	RWE_M	0
விளாவெலும்பு	விலாவெலும்பு	RWE_M	0
விளைவாசி உயர்வு 	விலைவாசி உயர்வு 	RWE_M	0
விழைவாசி உயர்வு 	விலைவாசி உயர்வு 	RWE_M	0
கரும்பு விலைந்தது 	கரும்பு விளைந்தது 	RWE_M	1
கரும்பு விழைந்தது 	கரும்பு விளைந்தது 	RWE_M	1
விலை என்பதன் பொருள் விரும்புதல் 	விழை என்பதன் பொருள் விரும்புதல் 	RWE_M	0
விளை என்பதன் பொருள் விரும்புதல் 	விழை என்பதன் பொருள் விரும்புதல் 	RWE_M	0
அன்னாய் கடிக்கும் 	அந்நாய் கடிக்கும் 	RWE_M	0
அந்நாய் என வணங்கினான் 	அன்னாய் என வணங்கினான் 	RWE_M	0
இன்னகை என்பதன் பொருள் இந்த நகை 	இந்நகை என்பதன் பொருள் இந்த நகை 	RWE_M	0
இந்நகை என்பதன் பொருள் இனிய நகைப்பு 	இன்னகை என்பதன் பொருள் இனிய நகைப்பு 	RWE_M	0
இன்னா என்பதன் பொருள் இந்த நாக்கு 	இந்நா என்பதன் பொருள் இந்த நாக்கு 	RWE_M	0
இந்நா என்பதன் பொருள் தீயவை 	இன்னா என்பதன் பொருள் தீயவை 	RWE_M	0
இன்னிலை என்பதன் பொருள் இந்த நிலை 	இந்நிலை என்பதன் பொருள் இந்த நிலை 	RWE_M	0
இந்நிலை என்பதன் பொருள் இனிய நிலை 	இன்னிலை என்பதன் பொருள் இனிய நிலை 	RWE_M	0
இன்னீர் என்பதன் பொருள் இந்த நீர் 	இந்நீர் என்பதன் பொருள் இந்த நீர் 	RWE_M	0
இந்நீர் என்பதன் பொருள் இனிய தன்மை  	இன்னீர் என்பதன் பொருள் இனிய தன்மை  	RWE_M	0
சென்னாய் ஒரு வகை நாய் 	செந்நாய் ஒரு வகை நாய் 	RWE_M	0
செந்நாய் என்பதன் பொருள் போகின்ற நாய் 	சென்னாய் என்பதன் பொருள் போகின்ற நாய் 	RWE_M	0
தேனீர் என்பதன் பொருள் தேயிலை நீர் 	தேநீர் என்பதன் பொருள் தேயிலை நீர் 	RWE_M	0
தேநீர் என்பதன் பொருள் தேன் கலந்த நீர் 	தேனீர் என்பதன் பொருள் தேன் கலந்த நீர் 	RWE_M	0
நன்னூல் என்பதன் பொருள் நம் நூல் 	நந்நூல் என்பதன் பொருள் நம் நூல் 	RWE_M	0
நந்நூல் என்பதன் நல்ல நூல் 	நன்னூல் என்பதன் நல்ல நூல் 	RWE_M	0
முன்னாள் என்பதன் பொருள் மூன்று நாட்கள் 	முந்நாள் என்பதன் பொருள் மூன்று நாட்கள் 	RWE_M	0
முந்நாள் என்பதன் பொருள் முன்னைய நாள் 	முன்னாள் என்பதன் பொருள் முன்னைய நாள் 	RWE_M	0
வென்னீர் என்பதன் பொருள் வெம்மையான நீர் 	வெந்நீர் என்பதன் பொருள் வெம்மையான நீர் 	RWE_M	0
வெந்நீர் என்பதன் பொருள் வெல்லும் தன்மை 	வென்னீர் என்பதன் பொருள் வெல்லும் தன்மை 	RWE_M	0
அணல் என்பதன் பொருள் நெருப்பு 	அனல் என்பதன் பொருள் நெருப்பு 	RWE_M	0
அனல் என்பதன் பொருள் கழுத்து 	அணல் என்பதன் பொருள் கழுத்து 	RWE_M	0
அனி என்பதன் பொருள் அழகு 	அணி என்பதன் பொருள் அழகு 	RWE_M	0
அணி என்பதன் பொருள் நெற்பொறி	அனி என்பதன் பொருள் நெற்பொறி	RWE_M	0
அனு என்பதன் பொருள் நுண்மை	அணு என்பதன் பொருள் நுண்மை	RWE_M	0
அணு என்பதன் பொருள் தாடை	அனு என்பதன் பொருள் தாடை	RWE_M	0
அனுக்கம் என்பதன் பொருள் அண்மை	அணுக்கம் என்பதன் பொருள் அண்மை	RWE_M	0
அணுக்கம் என்பதன் பொருள் அச்சம்	அனுக்கம் என்பதன் பொருள் அச்சம்	RWE_M	0
அனை என்பதன் பொருள் படுக்கை	அணை என்பதன் பொருள் படுக்கை	RWE_M	0
அனை என்பதன் பொருள் அணைத்துக் கொள்ளுதல்	அணை என்பதன் பொருள் அணைத்துக் கொள்ளுதல்	RWE_M	0
அணை என்பதன் பொருள் அன்னை	அனை என்பதன் பொருள் அன்னை	RWE_M	0
அணை என்பதன் பொருள் மீன்	அனை என்பதன் பொருள் மீன்	RWE_M	0
அனைய என்பதன் பொருள் சேர 	அணைய என்பதன் பொருள் சேர 	RWE_M	0
அனைய என்பதன் பொருள் அடைய	அணைய என்பதன் பொருள் அடைய	RWE_M	0
அணைய என்பதன் பொருள் அத்தகைய	அனைய என்பதன் பொருள் அத்தகைய	RWE_M	0
அன்மை என்பதன் பொருள் அருகில்	அண்மை என்பதன் பொருள் அருகில்	RWE_M	0
அண்மை என்பதன் பொருள் தீமை	அன்மை என்பதன் பொருள் தீமை	RWE_M	0
அங்கன் என்பதன் பொருள் அவ்விடம்	அங்கண் என்பதன் பொருள் அவ்விடம்	RWE_M	0
அங்கண் என்பதன் பொருள் மகன்	அங்கன் என்பதன் பொருள் மகன்	RWE_M	0
அன்னம் என்பதன் பொருள் மேல்வாய்	அண்ணம் என்பதன் பொருள் மேல்வாய்	RWE_M	0
அண்ணம் என்பதன் பொருள் சோறு	அன்னம் என்பதன் பொருள் சோறு	RWE_M	0
அண்ணம் என்பதன் பொருள் அன்னப்பறவை	அன்னம் என்பதன் பொருள் அன்னப்பறவை	RWE_M	0
அன்னன் என்பதன் பொருள் தமையன்	அண்ணன் என்பதன் பொருள் தமையன்	RWE_M	0
அண்ணன் என்பதன் பொருள் அத்தகையவன்	அன்னன் என்பதன் பொருள் அத்தகையவன்	RWE_M	0
அவன் என்பதன் பொருள் அவ்வாறு	அவண் என்பதன் பொருள் அவ்வாறு	RWE_M	0
அவண் செய்தான்	அவன் செய்தான்	RWE_M	0
ஆனகம் என்பதன் பொருள் சுரை	ஆணகம் என்பதன் பொருள் சுரை	RWE_M	0
ஆணகம் என்பதன் பொருள் துந்துபி	ஆனகம் என்பதன் பொருள் துந்துபி	RWE_M	0
ஆனம் என்பதன் பொருள் பற்றுக்கோடு	ஆணம் என்பதன் பொருள் பற்றுக்கோடு	RWE_M	0
ஆணம் என்பதன் பொருள் தெப்பம்	ஆனம் என்பதன் பொருள் தெப்பம்	RWE_M	0
ஆணம் என்பதன் பொருள் கள்	ஆனம் என்பதன் பொருள் கள்	RWE_M	0
ஆனி என்பதன் பொருள் எழுத்தாணி	ஆணி என்பதன் பொருள் எழுத்தாணி	RWE_M	0
ஆனி என்பதன் பொருள் இரும்பாணி	ஆணி என்பதன் பொருள் இரும்பாணி	RWE_M	0
ஆணி என்பது தமிழ் மாதங்களுள் ஒன்று	ஆனி என்பது தமிழ் மாதங்களுள் ஒன்று	RWE_M	0
ஆனேறு என்பதன் பொருள்  ஆண்மகன்	ஆணேறு என்பதன் பொருள்  ஆண்மகன்	RWE_M	0
ஆணேறு என்பதன் பொருள் காளை	ஆனேறு என்பதன் பொருள் காளை	RWE_M	0
ஆணேறு என்பதன் பொருள் எருது	ஆனேறு என்பதன் பொருள் எருது	RWE_M	0
ஆன் என்பதன் பொருள் ஆடவன்	ஆண் என்பதன் பொருள் ஆடவன்	RWE_M	0
ஆண் என்பதன் பொருள் பசு	ஆன் என்பதன் பொருள் பசு	RWE_M	0
ஆனை என்பதன் பொருள் கட்டளை	ஆணை என்பதன் பொருள் கட்டளை	RWE_M	0
ஆணை என்பதன் பொருள் யானை	ஆனை என்பதன் பொருள் யானை	RWE_M	0
இனை என்பதன் பொருள் துணை	இணை என்பதன் பொருள் துணை	RWE_M	0
இனை என்பதன் பொருள் இரட்டை	இணை என்பதன் பொருள் இரட்டை	RWE_M	0
இணை என்பதன் பொருள் வருத்தம்	இனை என்பதன் பொருள் வருத்தம்	RWE_M	0
இனைத்து என்பதன் பொருள் சேர்த்து	இணைத்து என்பதன் பொருள் சேர்த்து	RWE_M	0
இணைத்து என்பதன் பொருள் இத்தன்மையது	இனைத்து என்பதன் பொருள் இத்தன்மையது	RWE_M	0
இவன் என்பதன் பொருள் இவ்வாறு	இவண் என்பதன் பொருள் இவ்வாறு	RWE_M	0
இவண் என்ன வரைந்தான்?	இவன் என்ன வரைந்தான்?	RWE_M	0
ஈனவள் என்பதன் பொருள் ஈன்றவள்	ஈணவள் என்பதன் பொருள் ஈன்றவள்	RWE_M	0
ஈணவள் என்பதன் பொருள் இழிந்தவள்	ஈனவள் என்பதன் பொருள் இழிந்தவள்	RWE_M	0
உண் ஓவியம் 	உன் ஓவியம் 	RWE_M	0
சோறு உன்டான் 	சோறு உண்டான் 	RWE_M	1
உன்னல் என்பதன் பொருள் உண்ணுதல்	உண்ணல் என்பதன் பொருள் உண்ணுதல்	RWE_M	0
உண்ணல் என்பதன் பொருள் நினைத்தல்	உன்னல் என்பதன் பொருள் நினைத்தல்	RWE_M	0
உன்னி என்பதன் பொருள் ஒருவகைப் பூச்சி	உண்ணி என்பதன் பொருள் ஒருவகைப் பூச்சி	RWE_M	0
உன்னி என்பதன் பொருள் உண்பவன்	உண்ணி என்பதன் பொருள் உண்பவன்	RWE_M	0
உண்ணி என்பதன் பொருள் நினைத்து	உன்னி என்பதன் பொருள் நினைத்து	RWE_M	0
உண்ணி என்பதன் பொருள் குதிரை	உன்னி என்பதன் பொருள் குதிரை	RWE_M	0
ஊன் என்பதன் பொருள் உணவு	ஊண் என்பதன் பொருள் உணவு	RWE_M	0
ஊண் என்பதன் பொருள் மாமிசம்	ஊன் என்பதன் பொருள் மாமிசம்	RWE_M	0
அவளை என்னிக் கொண்டான் 	அவளை எண்ணிக் கொண்டான் 	RWE_M	1
விலை எண்ண?	விலை என்ன?	RWE_M	1
என்னல் என்பதன் பொருள் எண்ணுதல்	எண்ணல் என்பதன் பொருள் எண்ணுதல்	RWE_M	0
எண்ணல் என்பதன் பொருள் என்று சொல்லுதல்	என்னல் என்பதன் பொருள் என்று சொல்லுதல்	RWE_M	0
என்கு என்பதன் பொருள் கரடி	எண்கு என்பதன் பொருள் கரடி	RWE_M	0
எண்கு என்பதன் பொருள் என்று சொல்லுதல்	என்கு என்பதன் பொருள் என்று சொல்லுதல்	RWE_M	0
ஏன் என்பதன் பொருள் வலிமை	ஏண் என்பதன் பொருள் வலிமை	RWE_M	0
ஏன் என்பதன் பொருள் எல்லை 	ஏண் என்பதன் பொருள் எல்லை 	RWE_M	0
பெண் ஏண் அடிமையானாள்? 	பெண் ஏன் அடிமையானாள்? 	RWE_M	1
ஏனை என்பதன் பொருள் தொட்டில்	ஏணை என்பதன் பொருள் தொட்டில்	RWE_M	0
ஏணை என்பதன் பொருள் மற்றது	ஏனை என்பதன் பொருள் மற்றது	RWE_M	0
ஐவனம் என்பதன் பொருள் ஐந்து வண்ணம்	ஐவணம் என்பதன் பொருள் ஐந்து வண்ணம்	RWE_M	0
ஐவணம் என்பதன் பொருள் மலை நெல்	ஐவனம் என்பதன் பொருள் மலை நெல்	RWE_M	0
ஓனம் என்பதன் பொருள் ஒரு பண்டிகை	ஓணம் என்பதன் பொருள் ஒரு பண்டிகை	RWE_M	0
ஓணம் என்பதன் பொருள் எழுத்துச்சாரியை	ஓனம் என்பதன் பொருள் எழுத்துச்சாரியை	RWE_M	0
கனகம் என்பதன் பொருள் ஒரு படைப்பிரிவு	கணகம் என்பதன் பொருள் ஒரு படைப்பிரிவு	RWE_M	0
கணகம் என்பதன் பொருள் பொன்	கனகம் என்பதன் பொருள் பொன்	RWE_M	0
கனப்பு என்பதன் பொருள் குளிர்காயும் தீ	கணப்பு என்பதன் பொருள் குளிர்காயும் தீ	RWE_M	0
கணப்பு என்பதன் பொருள் பாரம்	கனப்பு என்பதன் பொருள் பாரம்	RWE_M	0
கணப்பு என்பதன் பொருள் அழுத்தம்	கனப்பு என்பதன் பொருள் அழுத்தம்	RWE_M	0
கனி என்பதன் பொருள் கணித்தல்	கணி என்பதன் பொருள் கணித்தல்	RWE_M	0
கணி என்பதன் பொருள் பழம்	கனி என்பதன் பொருள் பழம்	RWE_M	0
கணி என்பதன் பொருள் சுரங்கம்	கனி என்பதன் பொருள் சுரங்கம்	RWE_M	0
கணி என்பதன் பொருள் சாரம்	கனி என்பதன் பொருள் சாரம்	RWE_M	0
கனம் என்பதன் பொருள் கூட்டம்	கணம் என்பதன் பொருள் கூட்டம்	RWE_M	0
கணம் என்பதன் பொருள் பாரம்	கனம் என்பதன் பொருள் பாரம்	RWE_M	0
கன்னன் என்பதன் பொருள் கிருஷ்ணன்	கண்ணன் என்பதன் பொருள் கிருஷ்ணன்	RWE_M	0
கண்ணன் என்பதன் பொருள் கர்ணன்	கன்னன் என்பதன் பொருள் கர்ணன்	RWE_M	0
கன்னி என்பதன் பொருள் மாலை	கண்ணி என்பதன் பொருள் மாலை	RWE_M	0
கன்னி என்பதன் பொருள் கயிறு	கண்ணி என்பதன் பொருள் கயிறு	RWE_M	0
கன்னி என்பதன் பொருள் தாம்பு	கண்ணி என்பதன் பொருள் தாம்பு	RWE_M	0
கண்ணி என்பதன் பொருள் குமரிப்பெண்	கன்னி என்பதன் பொருள் குமரிப்பெண்	RWE_M	0
கண்ணி என்பதன் பொருள் உமை	கன்னி என்பதன் பொருள் உமை	RWE_M	0
கண்ணி ஒரு ராசி	கன்னி ஒரு ராசி	RWE_M	0
கனை என்பதன் பொருள் அம்பு	கணை என்பதன் பொருள் அம்பு	RWE_M	0
கணை என்பதன் பொருள் ஒலி	கனை என்பதன் பொருள் ஒலி	RWE_M	0
கணை என்பதன் பொருள் கனைத்தல்	கனை என்பதன் பொருள் கனைத்தல்	RWE_M	0
கன் என்பதன் பொருள் ஓர் உறுப்பு	கண் என்பதன் பொருள் ஓர் உறுப்பு	RWE_M	0
கண் என்பதன் பொருள் கல் 	கன் என்பதன் பொருள் கல் 	RWE_M	0
கண் என்பதன் பொருள் செம்பு	கன் என்பதன் பொருள் செம்பு	RWE_M	0
கண் என்பதன் பொருள் உறுதி	கன் என்பதன் பொருள் உறுதி	RWE_M	0
கன்று என்பதன் பொருள் அம்பு	கண்று என்பதன் பொருள் அம்பு	RWE_M	0
கண்று என்பதன் பொருள் அற்பம்	கன்று என்பதன் பொருள் அற்பம்	RWE_M	0
கண்று என்பதன் பொருள் இளமரம்	கன்று என்பதன் பொருள் இளமரம்	RWE_M	0
கண்று என்பதன் பொருள் குட்டி	கன்று என்பதன் பொருள் குட்டி	RWE_M	0
கண்று என்பதன் பொருள் கைவளை	கன்று என்பதன் பொருள் கைவளை	RWE_M	0
கன்னல் என்பதன் பொருள் கருதல்	கண்ணல் என்பதன் பொருள் கருதல்	RWE_M	0
கண்ணல் என்பதன் பொருள் கரும்பு	கன்னல் என்பதன் பொருள் கரும்பு	RWE_M	0
கண்ணல் என்பதன் பொருள் கற்கண்டு	கன்னல் என்பதன் பொருள் கற்கண்டு	RWE_M	0
கான் என்பதன் பொருள்  பார்	காண் என்பதன் பொருள்  பார்	RWE_M	0
காண் என்பதன் பொருள் காடு	கான் என்பதன் பொருள் காடு	RWE_M	0
காண் என்பதன் பொருள் வனம்	கான் என்பதன் பொருள் வனம்	RWE_M	0
கானம் என்பதன் பொருள் பொன்	காணம் என்பதன் பொருள் பொன்	RWE_M	0
கானம் என்பதன் பொருள் கொள்	காணம் என்பதன் பொருள் கொள்	RWE_M	0
காணம் என்பதன் பொருள் இசை	கானம் என்பதன் பொருள் இசை	RWE_M	0
காணம் என்பதன் பொருள் காடு	கானம் என்பதன் பொருள் காடு	RWE_M	0
காணம் என்பதன் பொருள் வனம்	கானம் என்பதன் பொருள் வனம்	RWE_M	0
காணம் என்பதன் பொருள் தேர்	கானம் என்பதன் பொருள் தேர்	RWE_M	0
கானல் என்பதன் பொருள் பார்த்தல்	காணல் என்பதன் பொருள் பார்த்தல்	RWE_M	0
காணல் என்பதன் பொருள் பாலை	கானல் என்பதன் பொருள் பாலை	RWE_M	0
கினி என்பதன் பொருள் கைத்தாளம்	கிணி என்பதன் பொருள் கைத்தாளம்	RWE_M	0
கிணி என்பதன் பொருள் பீடை	கினி என்பதன் பொருள் பீடை	RWE_M	0
கின்னம் என்பதன் பொருள் வட்டில்	கிண்ணம் என்பதன் பொருள் வட்டில்	RWE_M	0
கின்னம் என்பதன் பொருள் கிண்ணி	கிண்ணம் என்பதன் பொருள் கிண்ணி	RWE_M	0
கிண்ணம் என்பதன் பொருள் கிளை	கின்னம் என்பதன் பொருள் கிளை	RWE_M	0
கிண்ணம் என்பதன் பொருள் துன்பம்	கின்னம் என்பதன் பொருள் துன்பம்	RWE_M	0
குனி என்பதன் பொருள் வில்	குணி என்பதன் பொருள் வில்	RWE_M	0
குனி என்பதன் பொருள் ஊமை	குணி என்பதன் பொருள் ஊமை	RWE_M	0
குணி என்பதன் பொருள் குனிதல்	குனி என்பதன் பொருள் குனிதல்	RWE_M	0
குணி என்பதன் பொருள் வளை	குனி என்பதன் பொருள் வளை	RWE_M	0
குனித்தல் என்பதன் பொருள் மதித்தல்	குணித்தல் என்பதன் பொருள் மதித்தல்	RWE_M	0
குனித்தல் என்பதன் பொருள் எண்ணுதல்	குணித்தல் என்பதன் பொருள் எண்ணுதல்	RWE_M	0
குணித்தல் என்பதன் பொருள் வளைதல்	குனித்தல் என்பதன் பொருள் வளைதல்	RWE_M	0
குனிப்பு என்பதன் பொருள் அளவு	குணிப்பு என்பதன் பொருள் அளவு	RWE_M	0
குனிப்பு என்பதன் பொருள் ஆராய்ச்சி	குணிப்பு என்பதன் பொருள் ஆராய்ச்சி	RWE_M	0
குணிப்பு என்பதன் பொருள் வளைப்பு	குனிப்பு என்பதன் பொருள் வளைப்பு	RWE_M	0
குணிப்பு என்பதன் பொருள் ஆடல்	குனிப்பு என்பதன் பொருள் ஆடல்	RWE_M	0
கேனம் என்பதன் பொருள் செழிப்பு	கேணம் என்பதன் பொருள் செழிப்பு	RWE_M	0
கேனம் என்பதன் பொருள் மிகுதி	கேணம் என்பதன் பொருள் மிகுதி	RWE_M	0
கேணம் என்பதன் பொருள் பைத்தியம்	கேனம் என்பதன் பொருள் பைத்தியம்	RWE_M	0
கேணம் என்பதன் பொருள் பித்து	கேனம் என்பதன் பொருள் பித்து	RWE_M	0
கேனி என்பதன் பொருள் கிணறு	கேணி என்பதன் பொருள் கிணறு	RWE_M	0
கேணி என்பதன் பொருள் பித்துப் பிடித்தவர்	கேனி என்பதன் பொருள் பித்துப் பிடித்தவர்	RWE_M	0
கோன் என்பதன் பொருள் கோணல்	கோண் என்பதன் பொருள் கோணல்	RWE_M	0
கோன் என்பதன் பொருள் மாறுபாடு	கோண் என்பதன் பொருள் மாறுபாடு	RWE_M	0
கோண் என்பதன் பொருள் அரசன்	கோன் என்பதன் பொருள் அரசன்	RWE_M	0
சானம் என்பதன் பொருள் சாணைக்கல்	சாணம் என்பதன் பொருள் சாணைக்கல்	RWE_M	0
சானம் என்பதன் பொருள் சாணி	சாணம் என்பதன் பொருள் சாணி	RWE_M	0
சாணம் என்பதன் பொருள் அம்மி	சானம் என்பதன் பொருள் அம்மி	RWE_M	0
சாணம் என்பதன் பொருள் பெருங்காயம்	சானம் என்பதன் பொருள் பெருங்காயம்	RWE_M	0
சுனை என்பதன் பொருள் கூர்மை	சுணை என்பதன் பொருள் கூர்மை	RWE_M	0
சுனை என்பதன் பொருள் கரணை	சுணை என்பதன் பொருள் கரணை	RWE_M	0
சுணை என்பதன் பொருள் நீரூற்று	சுனை என்பதன் பொருள் நீரூற்று	RWE_M	0
சுன்னம் என்பதன் பொருள் வாசனைப் பொடி	சுண்ணம் என்பதன் பொருள் வாசனைப் பொடி	RWE_M	0
சுண்ணம் என்பதன் பொருள் சுண்ணாம்பு	சுன்னம் என்பதன் பொருள் சுண்ணாம்பு	RWE_M	0
சுண்ணம் என்பதன் பொருள் பூஜ்ஜியம்	சுன்னம் என்பதன் பொருள் பூஜ்ஜியம்	RWE_M	0
சேனம் என்பதன் பொருள் மெத்தை	சேணம் என்பதன் பொருள் மெத்தை	RWE_M	0
சேணம் என்பதன் பொருள் பருந்து	சேனம் என்பதன் பொருள் பருந்து	RWE_M	0
சேனை என்பதன் பொருள் அறிவு	சேணை என்பதன் பொருள் அறிவு	RWE_M	0
சேணை என்பதன் பொருள் படை	சேனை என்பதன் பொருள் படை	RWE_M	0
சோனம் என்பதன் பொருள் பொன்	சோணம் என்பதன் பொருள் பொன்	RWE_M	0
சோனம் என்பதன் பொருள் சிவப்பு	சோணம் என்பதன் பொருள் சிவப்பு	RWE_M	0
சோனம் என்பதன் பொருள் தீ	சோணம் என்பதன் பொருள் தீ	RWE_M	0
சோனம் என்பதன் பொருள் சோணகிரி	சோணம் என்பதன் பொருள் சோணகிரி	RWE_M	0
சோணம் என்பதன் பொருள் மேகம்	சோனம் என்பதன் பொருள் மேகம்	RWE_M	0
சோனை என்பதன் பொருள் ஒரு நதி	சோணை என்பதன் பொருள் ஒரு நதி	RWE_M	0
சோனை என்பதன் பொருள் சேரன் மனைவி	சோணை என்பதன் பொருள் சேரன் மனைவி	RWE_M	0
சோணை என்பதன் பொருள் மழைச்சாரல்	சோனை என்பதன் பொருள் மழைச்சாரல்	RWE_M	0
சோணை என்பதன் பொருள் மேகம்	சோனை என்பதன் பொருள் மேகம்	RWE_M	0
தன் என்பதன் பொருள் குளிர்ச்சி	தண் என்பதன் பொருள் குளிர்ச்சி	RWE_M	0
தண் என்பதன் பொருள் தன்னுடைய	தன் என்பதன் பொருள் தன்னுடைய	RWE_M	0
தனி என்பதன் பொருள் தணித்தல்	தணி என்பதன் பொருள் தணித்தல்	RWE_M	0
தணி என்பதன் பொருள் தனிமை	தனி என்பதன் பொருள் தனிமை	RWE_M	0
தானி என்பதன் பொருள் தான்றிமரம்	தாணி என்பதன் பொருள் தான்றிமரம்	RWE_M	0
தாணி என்பதன் பொருள் இருப்பிடம்	தானி என்பதன் பொருள் இருப்பிடம்	RWE_M	0
தாணி என்பதன் பொருள் பண்டசாலை	தானி என்பதன் பொருள் பண்டசாலை	RWE_M	0
தானு என்பதன் பொருள் சிவன்	தாணு என்பதன் பொருள் சிவன்	RWE_M	0
தானு என்பதன் பொருள் தூண்	தாணு என்பதன் பொருள் தூண்	RWE_M	0
தானு என்பதன் பொருள் நிலைப்பேறு	தாணு என்பதன் பொருள் நிலைப்பேறு	RWE_M	0
தாணு என்பதன் பொருள் காற்று	தானு என்பதன் பொருள் காற்று	RWE_M	0
தினை என்பதன் பொருள் ஒழுக்கம்	திணை என்பதன் பொருள் ஒழுக்கம்	RWE_M	0
தினை என்பதன் பொருள் குலம்	திணை என்பதன் பொருள் குலம்	RWE_M	0
திணை என்பதன் பொருள் தானியம்	தினை என்பதன் பொருள் தானியம்	RWE_M	0
திணை ஒருவகைப் புன்செய்ப் பயிர்	தினை ஒருவகைப் புன்செய்ப் பயிர்	RWE_M	0
தின்மை என்பதன் பொருள் உறுதி	திண்மை என்பதன் பொருள் உறுதி	RWE_M	0
திண்மை என்பதன் பொருள் தீமை	தின்மை என்பதன் பொருள் தீமை	RWE_M	0
தின் என்பதன் பொருள் வலிமை	திண் என்பதன் பொருள் வலிமை	RWE_M	0
திண் என்பதன் பொருள் உண்	தின் என்பதன் பொருள் உண்	RWE_M	0
துனி என்பதன் பொருள் துணிதல்	துணி என்பதன் பொருள் துணிதல்	RWE_M	0
துனி என்பதன் பொருள் கந்தை	துணி என்பதன் பொருள் கந்தை	RWE_M	0
துணி என்பதன் பொருள் அச்சம்	துனி என்பதன் பொருள் அச்சம்	RWE_M	0
துணி என்பதன் பொருள் ஊடல் நீட்டித்தல்	துனி என்பதன் பொருள் ஊடல் நீட்டித்தல்	RWE_M	0
தென் என்பதன் பொருள் தெளிவு	தெண் என்பதன் பொருள் தெளிவு	RWE_M	0
தெண் என்பதன் பொருள் தெற்கு	தென் என்பதன் பொருள் தெற்கு	RWE_M	0
தெண் என்பதன் பொருள் அழகு	தென் என்பதன் பொருள் அழகு	RWE_M	0
நன்பகல் என்பதன் பொருள் நடுப்பகல்	நண்பகல் என்பதன் பொருள் நடுப்பகல்	RWE_M	0
நண்பகல் என்பதன் பொருள் நல்லபகல்	நன்பகல் என்பதன் பொருள் நல்லபகல்	RWE_M	0
நனி என்பதன் பொருள் அணி 	நணி என்பதன் பொருள் அணி 	RWE_M	0
நனி என்பதன் பொருள் அழகு	நணி என்பதன் பொருள் அழகு	RWE_M	0
நணி என்பதன் பொருள் மிகுதி	நனி என்பதன் பொருள் மிகுதி	RWE_M	0
நான் என்பதன் பொருள் வெட்கம்	நாண் என்பதன் பொருள் வெட்கம்	RWE_M	0
நான் என்பதன் பொருள் கயிறு	நாண் என்பதன் பொருள் கயிறு	RWE_M	0
நாண் என்பது தன்மைப் பெயர்	நான் என்பது தன்மைப் பெயர்	RWE_M	0
நானம் என்பதன் பொருள் வெட்கம்	நாணம் என்பதன் பொருள் வெட்கம்	RWE_M	0
நாணம் என்பதன் பொருள் புனுகு	நானம் என்பதன் பொருள் புனுகு	RWE_M	0
நாணம் என்பதன் பொருள் கவரிமான்	நானம் என்பதன் பொருள் கவரிமான்	RWE_M	0
பனி என்பதன் பொருள் வேலை	பணி என்பதன் பொருள் வேலை	RWE_M	0
பனி என்பதன் பொருள் கட்டளையிடு	பணி என்பதன் பொருள் கட்டளையிடு	RWE_M	0
பணி என்பதன் பொருள் துன்பம்	பனி என்பதன் பொருள் துன்பம்	RWE_M	0
பணி என்பதன் பொருள் குளிர்	பனி என்பதன் பொருள் குளிர்	RWE_M	0
பணி என்பதன் பொருள் சொல்	பனி என்பதன் பொருள் சொல்	RWE_M	0
பணி என்பதன் பொருள் நோய்	பனி என்பதன் பொருள் நோய்	RWE_M	0
பனை என்பதன் பொருள் முரசு 	பணை என்பதன் பொருள் முரசு 	RWE_M	0
பனை என்பதன் பொருள் உயரம்	பணை என்பதன் பொருள் உயரம்	RWE_M	0
பனை என்பதன் பொருள் பரந்த	பணை என்பதன் பொருள் பரந்த	RWE_M	0
பணை ஒருவகை மரம்	பனை ஒருவகை மரம்	RWE_M	0
பன் என்பதன் பொருள் இசை	பண் என்பதன் பொருள் இசை	RWE_M	0
பண் என்பதன் பொருள் அரிவாள்	பன் என்பதன் பொருள் அரிவாள்	RWE_M	0
பண் என்பதன் பொருள் பல	பன் என்பதன் பொருள் பல	RWE_M	0
பன்னை என்பதன் பொருள் தோட்டம்	பண்ணை என்பதன் பொருள் தோட்டம்	RWE_M	0
பண்ணை என்பதன் பொருள் கீரைச்செடி	பன்னை என்பதன் பொருள் கீரைச்செடி	RWE_M	0
பன்னுதல் என்பதன் பொருள் செய்தல்	பண்ணுதல் என்பதன் பொருள் செய்தல்	RWE_M	0
பண்ணுதல் என்பதன் பொருள் நெருங்குதல்	பன்னுதல் என்பதன் பொருள் நெருங்குதல்	RWE_M	0
பன்னி என்பதன் பொருள் செய்து	பண்ணி என்பதன் பொருள் செய்து	RWE_M	0
பண்ணி என்பதன் பொருள் சீப்பு	பன்னி என்பதன் பொருள் சீப்பு	RWE_M	0
பண்ணி என்பதன் பொருள் பனிநீர்	பன்னி என்பதன் பொருள் பனிநீர்	RWE_M	0
பண்ணி என்பதன் பொருள் மனை	பன்னி என்பதன் பொருள் மனை	RWE_M	0
பண்ணி என்பதன் பொருள் சணல்	பன்னி என்பதன் பொருள் சணல்	RWE_M	0
பன்மை என்பதன் பொருள் தகுதி	பண்மை என்பதன் பொருள் தகுதி	RWE_M	0
பண்மை என்பதன் பொருள் பல	பன்மை என்பதன் பொருள் பல	RWE_M	0
பனித்தல் என்பதன் பொருள் கட்டளையிடுதல்	பணித்தல் என்பதன் பொருள் கட்டளையிடுதல்	RWE_M	0
பணித்தல் என்பதன் பொருள் துளித்தல்	பனித்தல் என்பதன் பொருள் துளித்தல்	RWE_M	0
பணித்தல் என்பதன் பொருள் தூறல்	பனித்தல் என்பதன் பொருள் தூறல்	RWE_M	0
பணித்தல் என்பதன் பொருள் விரிந்த	பனித்தல் என்பதன் பொருள் விரிந்த	RWE_M	0
பட்டனம் என்பதன் பொருள் நகரம்	பட்டணம் என்பதன் பொருள் நகரம்	RWE_M	0
பட்டிணம் என்பதன் பொருள் கடற்கரை நகர்	பட்டினம் என்பதன் பொருள் கடற்கரை நகர்	RWE_M	0
பானம் என்பதன் பொருள் நீருணவு	பாணம் என்பதன் பொருள் நீருணவு	RWE_M	0
பாணம் என்பதன் பொருள் அம்பு	பானம் என்பதன் பொருள் அம்பு	RWE_M	0
புனை என்பதன் பொருள் தெப்பம்	புணை என்பதன் பொருள் தெப்பம்	RWE_M	0
புணை என்பதன் பொருள் இட்டுக்கட்டுதல்	புனை என்பதன் பொருள் இட்டுக்கட்டுதல்	RWE_M	0
புணை என்பதன் பொருள் கற்பனை	புனை என்பதன் பொருள் கற்பனை	RWE_M	0
புன் என்பதன் பொருள் காயம்	புண் என்பதன் பொருள் காயம்	RWE_M	0
புண் என்பதன் பொருள் கீழான	புன் என்பதன் பொருள் கீழான	RWE_M	0
பேனம் என்பதன் பொருள் பேணுதல்	பேணம் என்பதன் பொருள் பேணுதல்	RWE_M	0
பேணம் என்பதன் பொருள் நுரை	பேனம் என்பதன் பொருள் நுரை	RWE_M	0
பேன் என்பதன் பொருள் போற்று	பேண் என்பதன் பொருள் போற்று	RWE_M	0
பேன் என்பதன் பொருள் உபசரி	பேண் என்பதன் பொருள் உபசரி	RWE_M	0
பேண் என்பதன் பொருள் ஓர் உயிரி	பேன் என்பதன் பொருள் ஓர் உயிரி	RWE_M	0
மனம் என்பதன் பொருள் வாசனை	மணம் என்பதன் பொருள் வாசனை	RWE_M	0
மனம் என்பதன் பொருள் திருமணம்	மணம் என்பதன் பொருள் திருமணம்	RWE_M	0
மணம் என்பதன் பொருள் உள்ளம்	மனம் என்பதன் பொருள் உள்ளம்	RWE_M	0
மணம் என்பதன் பொருள் இந்துப்பு	மனம் என்பதன் பொருள் இந்துப்பு	RWE_M	0
மனை என்பதன் பொருள் மரப்பலகை	மணை என்பதன் பொருள் மரப்பலகை	RWE_M	0
மனை என்பதன் பொருள் மணவறை	மணை என்பதன் பொருள் மணவறை	RWE_M	0
மணை என்பதன் பொருள் இடம்	மனை என்பதன் பொருள் இடம்	RWE_M	0
மணை என்பதன் பொருள் வீடு	மனை என்பதன் பொருள் வீடு	RWE_M	0
மன் என்பதன் பொருள் தரை	மண் என்பதன் பொருள் தரை	RWE_M	0
மன் என்பதன் பொருள் மண்வகை	மண் என்பதன் பொருள் மண்வகை	RWE_M	0
மண் என்பதன் பொருள் மன்னன்	மன் என்பதன் பொருள் மன்னன்	RWE_M	0
மண் என்பதன் பொருள் பெருமை	மன் என்பதன் பொருள் பெருமை	RWE_M	0
மன்னை என்பதன் பொருள் இளமை	மண்ணை என்பதன் பொருள் இளமை	RWE_M	0
மன்னை என்பது கொடி வகை	மண்ணை என்பது கொடி வகை	RWE_M	0
மண்ணை என்பதன் பொருள் தொண்டை	மன்னை என்பதன் பொருள் தொண்டை	RWE_M	0
மண்ணை என்பதன் பொருள் கோபம்	மன்னை என்பதன் பொருள் கோபம்	RWE_M	0
மானி என்பதன் பொருள் அழகு	மாணி என்பதன் பொருள் அழகு	RWE_M	0
மானி என்பதன் பொருள் பிரம்மசாரி	மாணி என்பதன் பொருள் பிரம்மசாரி	RWE_M	0
மாணி என்பதன் பொருள் மானம் உடையவர்	மானி என்பதன் பொருள் மானம் உடையவர்	RWE_M	0
மான் என்பதன் பொருள் மாட்சிமை	மாண் என்பதன் பொருள் மாட்சிமை	RWE_M	0
மாண் என்பதன் பொருள் ஒரு விலங்கு	மான் என்பதன் பொருள் ஒரு விலங்கு	RWE_M	0
முனை என்பதன் பொருள் வெறுப்பு	முணை என்பதன் பொருள் வெறுப்பு	RWE_M	0
முனை என்பதன் பொருள் மிகுதி	முணை என்பதன் பொருள் மிகுதி	RWE_M	0
முணை என்பதன் பொருள் முன்பகுதி	முனை என்பதன் பொருள் முன்பகுதி	RWE_M	0
முணை என்பதன் பொருள் துணிவு	முனை என்பதன் பொருள் துணிவு	RWE_M	0
முணை என்பதன் பொருள் முதன்மை	முனை என்பதன் பொருள் முதன்மை	RWE_M	0
வனம் என்பதன் பொருள் ஓசை	வணம் என்பதன் பொருள் ஓசை	RWE_M	0
வணம் என்பதன் பொருள் காடு	வனம் என்பதன் பொருள் காடு	RWE_M	0
வணம் என்பதன் பொருள் துளசி	வனம் என்பதன் பொருள் துளசி	RWE_M	0
வன்மை என்பதன் பொருள் வளப்பம்	வண்மை என்பதன் பொருள் வளப்பம்	RWE_M	0
வன்மை என்பதன் பொருள் கொடை	வண்மை என்பதன் பொருள் கொடை	RWE_M	0
வண்மை என்பதன் பொருள் உறுதி	வன்மை என்பதன் பொருள் உறுதி	RWE_M	0
வண்மை என்பதன் பொருள் வலிமை	வன்மை என்பதன் பொருள் வலிமை	RWE_M	0
வன்னம் என்பதன் பொருள் நிறம்	வண்ணம் என்பதன் பொருள் நிறம்	RWE_M	0
வன்னம் என்பதன் பொருள் குணம்	வண்ணம் என்பதன் பொருள் குணம்	RWE_M	0
வன்னம் என்பதன் பொருள் அழகு	வண்ணம் என்பதன் பொருள் அழகு	RWE_M	0
வண்ணம் என்பதன் பொருள் எழுத்து	வன்னம் என்பதன் பொருள் எழுத்து	RWE_M	0
வண்ணம் என்பதன் பொருள் நிறம்	வன்னம் என்பதன் பொருள் நிறம்	RWE_M	0
வானகம் என்பதன் பொருள் அக்கினி 	வாணகம் என்பதன் பொருள் அக்கினி 	RWE_M	0
வானகம்  என்பதன் பொருள் பசுமடி	வாணகம் என்பதன் பொருள் பசுமடி	RWE_M	0
வாணகம் என்பதன் பொருள் மேலுலகம்	வானகம் என்பதன் பொருள் மேலுலகம்	RWE_M	0
வானம் என்பதன் பொருள் அம்பு	வாணம் என்பதன் பொருள் அம்பு	RWE_M	0
வானம் என்பதன் பொருள் தீ	வாணம் என்பதன் பொருள் தீ	RWE_M	0
வானம் என்பதன் பொருள் மத்தாப்பு	வாணம் என்பதன் பொருள் மத்தாப்பு	RWE_M	0
வாணம் என்பதன் பொருள் ஆகாயம்	வானம் என்பதன் பொருள் ஆகாயம்	RWE_M	0
வாணம் என்பதன் பொருள் மழை	வானம் என்பதன் பொருள் மழை	RWE_M	0
வானி என்பதன் பொருள் கலைமகள்	வாணி என்பதன் பொருள் கலைமகள்	RWE_M	0
வானி என்பதன் பொருள் சரஸ்வதி	வாணி என்பதன் பொருள் சரஸ்வதி	RWE_M	0
வாணி என்பதன் பொருள் துகிற்கொடி	வானி என்பதன் பொருள் துகிற்கொடி	RWE_M	0
அளகு என்பதன் பொருள் பறவையின் மூக்கு	அலகு என்பதன் பொருள் பறவையின் மூக்கு	RWE_M	0
அழகு என்பதன் பொருள் பறவையின் மூக்கு	அலகு என்பதன் பொருள் பறவையின் மூக்கு	RWE_M	0
அலகு என்பதன் பொருள் வனப்பு	அழகு என்பதன் பொருள் வனப்பு	RWE_M	0
அளகு என்பதன் பொருள் வனப்பு	அழகு என்பதன் பொருள் வனப்பு	RWE_M	0
அழகு என்பதன் பொருள் சேவல்	அளகு என்பதன் பொருள் சேவல்	RWE_M	0
அலகு என்பதன் பொருள் சேவல்	அளகு என்பதன் பொருள் சேவல்	RWE_M	0
அழகு என்பதன் பொருள் பெண்கூகை	அளகு என்பதன் பொருள் பெண்கூகை	RWE_M	0
அலகு என்பதன் பொருள் பெண்கூகை	அளகு என்பதன் பொருள் பெண்கூகை	RWE_M	0
அளகம் என்பதன் பொருள் திப்பிலி	அலகம் என்பதன் பொருள் திப்பிலி	RWE_M	0
அழகம் என்பதன் பொருள் திப்பிலி	அலகம் என்பதன் பொருள் திப்பிலி	RWE_M	0
அலகம் என்பதன் பொருள் வெள்ளெருக்கு	அளகம் என்பதன் பொருள் வெள்ளெருக்கு	RWE_M	0
அழகம் என்பதன் பொருள் வெள்ளெருக்கு	அளகம் என்பதன் பொருள் வெள்ளெருக்கு	RWE_M	0
அலகம் என்பதன் பொருள் நீர்	அளகம் என்பதன் பொருள் நீர்	RWE_M	0
அழகம் என்பதன் பொருள் நீர்	அளகம் என்பதன் பொருள் நீர்	RWE_M	0
அளகை என்பதன் பொருள் கற்றாழை	அலகை என்பதன் பொருள் கற்றாழை	RWE_M	0
அழகை என்பதன் பொருள் கற்றாழை	அலகை என்பதன் பொருள் கற்றாழை	RWE_M	0
அளகை என்பதன் பொருள் பேய்	அலகை என்பதன் பொருள் பேய்	RWE_M	0
அழகை என்பதன் பொருள் பேய்	அலகை என்பதன் பொருள் பேய்	RWE_M	0
அலகை என்பதன் பொருள் அளகாபுரி	அளகை என்பதன் பொருள் அளகாபுரி	RWE_M	0
அழகை என்பதன் பொருள் அளகாபுரி	அளகை என்பதன் பொருள் அளகாபுரி	RWE_M	0
அலகை என்பதன் பொருள் பெண்	அளகை என்பதன் பொருள் பெண்	RWE_M	0
அழகை என்பதன் பொருள் பெண்	அளகை என்பதன் பொருள் பெண்	RWE_M	0
அலம் என்பதன் பொருள் பிணம்	அழம் என்பதன் பொருள் பிணம்	RWE_M	0
அளம் என்பதன் பொருள் கலப்பை	அலம் என்பதன் பொருள் கலப்பை	RWE_M	0
அலம் என்பதன் பொருள் உப்பு	அளம் என்பதன் பொருள் உப்பு	RWE_M	0
அழம் என்பதன் பொருள் உப்பு	அளம் என்பதன் பொருள் உப்பு	RWE_M	0
அளத்தல் என்பதன் பொருள் அலட்டல்	அலத்தல் என்பதன் பொருள் அலட்டல்	RWE_M	0
அழத்தல் என்பதன் பொருள் அலட்டல்	அலத்தல் என்பதன் பொருள் அலட்டல்	RWE_M	0
அளத்தல் என்பதன் பொருள் அலைதல்	அலத்தல் என்பதன் பொருள் அலைதல்	RWE_M	0
அழத்தல் என்பதன் பொருள் அலைதல்	அலத்தல் என்பதன் பொருள் அலைதல்	RWE_M	0
அலத்தல் என்பதன் பொருள் அளவிடுதல்	அளத்தல் என்பதன் பொருள் அளவிடுதல்	RWE_M	0
அழத்தல் என்பதன் பொருள் அளவிடுதல்	அளத்தல் என்பதன் பொருள் அளவிடுதல்	RWE_M	0
அலத்தல் என்பதன் பொருள் மதித்தல்	அளத்தல் என்பதன் பொருள் மதித்தல்	RWE_M	0
அழத்தல் என்பதன் பொருள் மதித்தல்	அளத்தல் என்பதன் பொருள் மதித்தல்	RWE_M	0
அளவன் என்பதன் பொருள் ஆண்நண்டு	அலவன் என்பதன் பொருள் ஆண்நண்டு	RWE_M	0
அழவன் என்பதன் பொருள் ஆண்நண்டு	அலவன் என்பதன் பொருள் ஆண்நண்டு	RWE_M	0
அலவன் என்பதன் பொருள் அளப்பவன்	அளவன் என்பதன் பொருள் அளப்பவன்	RWE_M	0
அழவன் என்பதன் பொருள் அளப்பவன்	அளவன் என்பதன் பொருள் அளப்பவன்	RWE_M	0
அலவன் என்பதன் பொருள் உப்பு எடுப்போன்	அளவன் என்பதன் பொருள் உப்பு எடுப்போன்	RWE_M	0
அழவன் என்பதன் பொருள் உப்பு எடுப்போன்	அளவன் என்பதன் பொருள் உப்பு எடுப்போன்	RWE_M	0
அலி என்பதன் பொருள் அழித்துவிடு	அழி என்பதன் பொருள் அழித்துவிடு	RWE_M	0
அளி என்பதன் பொருள் அழித்துவிடு	அழி என்பதன் பொருள் அழித்துவிடு	RWE_M	0
அளி என்பதன் பொருள் பேடி	அலி என்பதன் பொருள் பேடி	RWE_M	0
அழி என்பதன் பொருள் பேடி	அலி என்பதன் பொருள் பேடி	RWE_M	0
அளி என்பதன் பொருள் காகம்	அலி என்பதன் பொருள் காகம்	RWE_M	0
அழி என்பதன் பொருள் காகம்	அலி என்பதன் பொருள் காகம்	RWE_M	0
அளி என்பதன் பொருள் விருச்சிகராசி	அலி என்பதன் பொருள் விருச்சிகராசி	RWE_M	0
அழி என்பதன் பொருள் விருச்சிகராசி	அலி என்பதன் பொருள் விருச்சிகராசி	RWE_M	0
அலி என்பதன் பொருள் கருணை	அளி என்பதன் பொருள் கருணை	RWE_M	0
அழி என்பதன் பொருள் கருணை	அளி என்பதன் பொருள் கருணை	RWE_M	0
அலி என்பதன் பொருள் கள்	அளி என்பதன் பொருள் கள்	RWE_M	0
அழி என்பதன் பொருள் கள்	அளி என்பதன் பொருள் கள்	RWE_M	0
அலி என்பதன் பொருள் வண்டு	அளி என்பதன் பொருள் வண்டு	RWE_M	0
அழி என்பதன் பொருள் வண்டு	அளி என்பதன் பொருள் வண்டு	RWE_M	0
அள்ளல் என்பதன் பொருள் துன்பம்	அல்லல் என்பதன் பொருள் துன்பம்	RWE_M	0
அள்ளல் என்பதன் பொருள் துன்பம்	அல்லல் என்பதன் பொருள் துன்பம்	RWE_M	0
அல்லல் என்பதன் பொருள் வாரி எடுத்தல்	அள்ளல் என்பதன் பொருள் வாரி எடுத்தல்	RWE_M	0
அல்லல் என்பதன் பொருள் வாரி எடுத்தல்	அள்ளல் என்பதன் பொருள் வாரி எடுத்தல்	RWE_M	0
அளை என்பதன் பொருள் கூப்பிடு	அழை என்பதன் பொருள் கூப்பிடு	RWE_M	0
அலை என்பதன் பொருள் கூப்பிடு	அழை என்பதன் பொருள் கூப்பிடு	RWE_M	0
அழை என்பதன் பொருள் கடல்	அலை என்பதன் பொருள் கடல்	RWE_M	0
அளை என்பதன் பொருள் கடல்	அலை என்பதன் பொருள் கடல்	RWE_M	0
அளை என்பதன் பொருள் நீரலை	அலை என்பதன் பொருள் நீரலை	RWE_M	0
அழை என்பதன் பொருள் அலைதல்	அலை என்பதன் பொருள் அலைதல்	RWE_M	0
அலை என்பதன் பொருள் தயிர்	அளை என்பதன் பொருள் தயிர்	RWE_M	0
அழை என்பதன் பொருள் தயிர்	அளை என்பதன் பொருள் தயிர்	RWE_M	0
அழை என்பதன் பொருள் நண்டு	அளை என்பதன் பொருள் நண்டு	RWE_M	0
அலை என்பதன் பொருள் நண்டு	அளை என்பதன் பொருள் நண்டு	RWE_M	0
அலை என்பதன் பொருள் புற்று	அளை என்பதன் பொருள் புற்று	RWE_M	0
அழை என்பதன் பொருள் புற்று	அளை என்பதன் பொருள் புற்று	RWE_M	0
அவழ் என்பதன் பொருள் பள்ளம்	அவல் என்பதன் பொருள் பள்ளம்	RWE_M	0
அவள் என்பதன் பொருள் பள்ளம்	அவல் என்பதன் பொருள் பள்ளம்	RWE_M	0
அவள் ஒரு உணவுப் பொருள்	அவல் ஒரு உணவுப் பொருள்	RWE_M	0
அவழ் ஒரு உணவுப் பொருள்	அவல் ஒரு உணவுப் பொருள்	RWE_M	0
அவல் ஒரு மருத்துவர் 	அவள் ஒரு மருத்துவர் 	RWE_M	0
அவழ் ஒரு மருத்துவர் 	அவள் ஒரு மருத்துவர் 	RWE_M	0
அள் என்பதன் பொருள் இரவு	அல் என்பதன் பொருள் இரவு	RWE_M	0
அழ் என்பதன் பொருள் இரவு	அல் என்பதன் பொருள் இரவு	RWE_M	0
அல் என்பதன் பொருள் அள்ளி எடு	அள் என்பதன் பொருள் அள்ளி எடு	RWE_M	0
அழ் என்பதன் பொருள் அள்ளி எடு	அள் என்பதன் பொருள் அள்ளி எடு	RWE_M	0
அல் என்பதன் பொருள் நெருக்கம்	அள் என்பதன் பொருள் நெருக்கம்	RWE_M	0
அழ் என்பதன் பொருள் நெருக்கம்	அள் என்பதன் பொருள் நெருக்கம்	RWE_M	0
உளவு என்பதன் பொருள் நடப்பது	உலவு என்பதன் பொருள் நடப்பது	RWE_M	0
உழவு என்பதன் பொருள் நடப்பது	உலவு என்பதன் பொருள் நடப்பது	RWE_M	0
உழவு என்பதன் பொருள் ஒற்று	உளவு என்பதன் பொருள் ஒற்று	RWE_M	0
உலவு என்பதன் பொருள் ஒற்று	உளவு என்பதன் பொருள் ஒற்று	RWE_M	0
உலவு என்பதன் பொருள் கலப்பையால் உழுதல்	உழவு என்பதன் பொருள் கலப்பையால் உழுதல்	RWE_M	0
உளவு என்பதன் பொருள் கலப்பையால் உழுதல்	உழவு என்பதன் பொருள் கலப்பையால் உழுதல்	RWE_M	0
உளி என்பதன் பொருள் இடம்	உழி என்பதன் பொருள் இடம்	RWE_M	0
உலி என்பதன் பொருள் இடம்	உழி என்பதன் பொருள் இடம்	RWE_M	0
உலி என்பதன் பொருள் பொழுது	உழி என்பதன் பொருள் பொழுது	RWE_M	0
உளி என்பதன் பொருள் பொழுது	உழி என்பதன் பொருள் பொழுது	RWE_M	0
உலி என்பதன் பொருள் தச்சுக் கருவிகளுள் ஒன்று	உளி என்பதன் பொருள் தச்சுக் கருவிகளுள் ஒன்று	RWE_M	0
உழி என்பதன் பொருள் தச்சுக் கருவிகளுள் ஒன்று	உளி என்பதன் பொருள் தச்சுக் கருவிகளுள் ஒன்று	RWE_M	0
உளு என்பதன் பொருள் தானியப் பதர்	உலு என்பதன் பொருள் தானியப் பதர்	RWE_M	0
உழு என்பதன் பொருள் தானியப் பதர்	உலு என்பதன் பொருள் தானியப் பதர்	RWE_M	0
உலு என்பதன் பொருள் நிலத்தை உழு	உழு என்பதன் பொருள் நிலத்தை உழு	RWE_M	0
உளு என்பதன் பொருள் நிலத்தை உழு	உழு என்பதன் பொருள் நிலத்தை உழு	RWE_M	0
உலு என்பதன் பொருள் உளுத்துப் போதல்	உளு என்பதன் பொருள் உளுத்துப் போதல்	RWE_M	0
உழு என்பதன் பொருள் உளுத்துப் போதல்	உளு என்பதன் பொருள் உளுத்துப் போதல்	RWE_M	0
உழை என்பதன் பொருள் கொல்லன் உலை	உலை என்பதன் பொருள் கொல்லன் உலை	RWE_M	0
உளை என்பதன் பொருள் கொல்லன் உலை	உலை என்பதன் பொருள் கொல்லன் உலை	RWE_M	0
உழை என்பதன் பொருள் நீருலை	உலை என்பதன் பொருள் நீருலை	RWE_M	0
உளை என்பதன் பொருள் நீருலை	உலை என்பதன் பொருள் நீருலை	RWE_M	0
உளை என்பதன் பொருள் பாடுபடு	உழை என்பதன் பொருள் பாடுபடு	RWE_M	0
உலை என்பதன் பொருள் பாடுபடு	உழை என்பதன் பொருள் பாடுபடு	RWE_M	0
உளை என்பதன் பொருள் பக்கம்	உழை என்பதன் பொருள் பக்கம்	RWE_M	0
உலை என்பதன் பொருள் பக்கம்	உழை என்பதன் பொருள் பக்கம்	RWE_M	0
உலை என்பதன் பொருள் கலைமான்	உழை என்பதன் பொருள் கலைமான்	RWE_M	0
உளை என்பதன் பொருள் கலைமான்	உழை என்பதன் பொருள் கலைமான்	RWE_M	0
உழை என்பதன் பொருள் பிடரி மயிர்	உளை என்பதன் பொருள் பிடரி மயிர்	RWE_M	0
உலை என்பதன் பொருள் பிடரி மயிர்	உளை என்பதன் பொருள் பிடரி மயிர்	RWE_M	0
உழை என்பதன் பொருள் சேறு	உளை என்பதன் பொருள் சேறு	RWE_M	0
உலை என்பதன் பொருள் சேறு	உளை என்பதன் பொருள் சேறு	RWE_M	0
உலை என்பதன் பொருள் தலை	உளை என்பதன் பொருள் தலை	RWE_M	0
உழை என்பதன் பொருள் தலை	உளை என்பதன் பொருள் தலை	RWE_M	0
உளுவை என்பதன் பொருள் புலி	உழுவை என்பதன் பொருள் புலி	RWE_M	0
உளுவை என்பதன் பொருள் புலி	உழுவை என்பதன் பொருள் புலி	RWE_M	0
உழுவை என்பதன் பொருள் மீன்வகை	உளுவை என்பதன் பொருள் மீன்வகை	RWE_M	0
உழுவை என்பதன் பொருள் மீன்வகை	உளுவை என்பதன் பொருள் மீன்வகை	RWE_M	0
எள் என்பதன் பொருள் கல்	எல் என்பதன் பொருள் கல்	RWE_M	0
எள் என்பதன் பொருள் மாலை	எல் என்பதன் பொருள் மாலை	RWE_M	0
எள் என்பதன் பொருள் சூரியன்	எல் என்பதன் பொருள் சூரியன்	RWE_M	0
எல் என்பதன் பொருள் எண்ணெய் வித்து	எள் என்பதன் பொருள் எண்ணெய் வித்து	RWE_M	0
எல் என்பதன் பொருள் நிந்தை	எள் என்பதன் பொருள் நிந்தை	RWE_M	0
எழு என்பதன் பொருள் கரடி	எலு என்பதன் பொருள் கரடி	RWE_M	0
எழு என்பதன் பொருள் கரடி	எலு என்பதன் பொருள் கரடி	RWE_M	0
எலு என்பதன் பொருள் எழுந்திரு	எழு என்பதன் பொருள் எழுந்திரு	RWE_M	0
எலு என்பதன் பொருள் எழுந்திரு	எழு என்பதன் பொருள் எழுந்திரு	RWE_M	0
எலு என்பதன் பொருள் தூண்	எழு என்பதன் பொருள் தூண்	RWE_M	0
எலு என்பதன் பொருள் தூண்	எழு என்பதன் பொருள் தூண்	RWE_M	0
ஒளி என்பதன் பொருள் சப்தம்	ஒலி என்பதன் பொருள் சப்தம்	RWE_M	0
ஒழி என்பதன் பொருள் சப்தம்	ஒலி என்பதன் பொருள் சப்தம்	RWE_M	0
ஒளி என்பதன் பொருள் நாதம்	ஒலி என்பதன் பொருள் நாதம்	RWE_M	0
ஒழி என்பதன் பொருள் நாதம்	ஒலி என்பதன் பொருள் நாதம்	RWE_M	0
ஒளி என்பதன் பொருள் காற்று	ஒலி என்பதன் பொருள் காற்று	RWE_M	0
ஒழி என்பதன் பொருள் காற்று	ஒலி என்பதன் பொருள் காற்று	RWE_M	0
ஒலி என்பதன் பொருள் அழி	ஒழி என்பதன் பொருள் அழி	RWE_M	0
ஒளி என்பதன் பொருள் அழி	ஒழி என்பதன் பொருள் அழி	RWE_M	0
ஒலி என்பதன் பொருள் தவிர்	ஒழி என்பதன் பொருள் தவிர்	RWE_M	0
ஒளி என்பதன் பொருள் தவிர்	ஒழி என்பதன் பொருள் தவிர்	RWE_M	0
ஒலி என்பதன் பொருள் கொல்	ஒழி என்பதன் பொருள் கொல்	RWE_M	0
ஒளி என்பதன் பொருள் கொல்	ஒழி என்பதன் பொருள் கொல்	RWE_M	0
ஒலி என்பதன் பொருள் துற	ஒழி என்பதன் பொருள் துற	RWE_M	0
ஒளி என்பதன் பொருள் துற	ஒழி என்பதன் பொருள் துற	RWE_M	0
ஒலி என்பதன் பொருள் வெளிச்சம்	ஒளி என்பதன் பொருள் வெளிச்சம்	RWE_M	0
ஒழி என்பதன் பொருள் வெளிச்சம்	ஒளி என்பதன் பொருள் வெளிச்சம்	RWE_M	0
ஒலி என்பதன் பொருள் மறைத்து வை	ஒளி என்பதன் பொருள் மறைத்து வை	RWE_M	0
ஒழி என்பதன் பொருள் மறைத்து வை	ஒளி என்பதன் பொருள் மறைத்து வை	RWE_M	0
ஒள் என்பதன் பொருள் ஒலிக்குறிப்பு	ஒல் என்பதன் பொருள் ஒலிக்குறிப்பு	RWE_M	0
ஒல் என்பதன் பொருள் அழகு	ஒள் என்பதன் பொருள் அழகு	RWE_M	0
ஒல் என்பதன் பொருள் உண்மை	ஒள் என்பதன் பொருள் உண்மை	RWE_M	0
ஒல் என்பதன் பொருள் அறிவு	ஒள் என்பதன் பொருள் அறிவு	RWE_M	0
ஒல் என்பதன் பொருள் ஒளி	ஒள் என்பதன் பொருள் ஒளி	RWE_M	0
கழகம் என்பதன் பொருள் போர்	கலகம் என்பதன் பொருள் போர்	RWE_M	0
கழகம் என்பதன் பொருள் அமளி	கலகம் என்பதன் பொருள் அமளி	RWE_M	0
கழகம் என்பதன் பொருள் இரைச்சல்	கலகம் என்பதன் பொருள் இரைச்சல்	RWE_M	0
கலகம் என்பதன் பொருள் சங்கம்	கழகம் என்பதன் பொருள் சங்கம்	RWE_M	0
கலகம் என்பதன் பொருள் கூட்டமைப்பு	கழகம் என்பதன் பொருள் கூட்டமைப்பு	RWE_M	0
களங்கம் என்பதன் பொருள் கழங்கு	கழங்கம் என்பதன் பொருள் கழங்கு	RWE_M	0
களங்கம் என்பதன் பொருள் கழங்கு	கழங்கம் என்பதன் பொருள் கழங்கு	RWE_M	0
களங்கம் என்பதன் பொருள் விளையாட்டுக் கருவி	கழங்கம் என்பதன் பொருள் விளையாட்டுக் கருவி	RWE_M	0
களங்கம் என்பதன் பொருள் விளையாட்டுக் கருவி	கழங்கம் என்பதன் பொருள் விளையாட்டுக் கருவி	RWE_M	0
கழங்கம் என்பதன் பொருள் குற்றம்	களங்கம் என்பதன் பொருள் குற்றம்	RWE_M	0
கழங்கம் என்பதன் பொருள் குற்றம்	களங்கம் என்பதன் பொருள் குற்றம்	RWE_M	0
கழங்கம் என்பதன் பொருள் அழுக்கு	களங்கம் என்பதன் பொருள் அழுக்கு	RWE_M	0
கழங்கம் என்பதன் பொருள் அழுக்கு	களங்கம் என்பதன் பொருள் அழுக்கு	RWE_M	0
கழி என்பதன் பொருள் கலியுகம்	கலி என்பதன் பொருள் கலியுகம்	RWE_M	0
களி என்பதன் பொருள் கலியுகம்	கலி என்பதன் பொருள் கலியுகம்	RWE_M	0
கழி என்பதன் பொருள் பாவகை	கலி என்பதன் பொருள் பாவகை	RWE_M	0
களி என்பதன் பொருள் பாவகை	கலி என்பதன் பொருள் பாவகை	RWE_M	0
கழி என்பதன் பொருள் சனி	கலி என்பதன் பொருள் சனி	RWE_M	0
களி என்பதன் பொருள் சனி	கலி என்பதன் பொருள் சனி	RWE_M	0
கலி என்பதன் பொருள் கோல்	கழி என்பதன் பொருள் கோல்	RWE_M	0
களி என்பதன் பொருள் கோல்	கழி என்பதன் பொருள் கோல்	RWE_M	0
கலி என்பதன் பொருள் மிகுதி	கழி என்பதன் பொருள் மிகுதி	RWE_M	0
களி என்பதன் பொருள் மிகுதி	கழி என்பதன் பொருள் மிகுதி	RWE_M	0
கலி என்பதன் பொருள் உப்பளம்	கழி என்பதன் பொருள் உப்பளம்	RWE_M	0
களி என்பதன் பொருள் உப்பளம்	கழி என்பதன் பொருள் உப்பளம்	RWE_M	0
கலி என்பதன் பொருள் மகிழ்வு	களி என்பதன் பொருள் மகிழ்வு	RWE_M	0
கழி என்பதன் பொருள் மகிழ்வு	களி என்பதன் பொருள் மகிழ்வு	RWE_M	0
கலி என்பதன் பொருள் இன்பம்	களி என்பதன் பொருள் இன்பம்	RWE_M	0
கழி என்பதன் பொருள் இன்பம்	களி என்பதன் பொருள் இன்பம்	RWE_M	0
கழை என்பதன் பொருள் ஆண்மான்	கலை என்பதன் பொருள் ஆண்மான்	RWE_M	0
களை என்பதன் பொருள் ஆண்மான்	கலை என்பதன் பொருள் ஆண்மான்	RWE_M	0
கழை என்பதன் பொருள் சந்திரன்	கலை என்பதன் பொருள் சந்திரன்	RWE_M	0
களை என்பதன் பொருள் சந்திரன்	கலை என்பதன் பொருள் சந்திரன்	RWE_M	0
கழை என்பதன் பொருள் கல்வி	கலை என்பதன் பொருள் கல்வி	RWE_M	0
களை என்பதன் பொருள் கல்வி	கலை என்பதன் பொருள் கல்வி	RWE_M	0
கலை என்பதன் பொருள் மூங்கில்	கழை என்பதன் பொருள் மூங்கில்	RWE_M	0
களை என்பதன் பொருள் மூங்கில்	கழை என்பதன் பொருள் மூங்கில்	RWE_M	0
கலை என்பதன் பொருள் கரும்பு	கழை என்பதன் பொருள் கரும்பு	RWE_M	0
களை என்பதன் பொருள் கரும்பு	கழை என்பதன் பொருள் கரும்பு	RWE_M	0
கலை என்பதன் பொருள் புனர்பூசம்	கழை என்பதன் பொருள் புனர்பூசம்	RWE_M	0
களை என்பதன் பொருள் புனர்பூசம்	கழை என்பதன் பொருள் புனர்பூசம்	RWE_M	0
கழை என்பதன் பொருள் அழகு	களை என்பதன் பொருள் அழகு	RWE_M	0
கலை என்பதன் பொருள் அழகு	களை என்பதன் பொருள் அழகு	RWE_M	0
கழை என்பதன் பொருள் புல் பூண்டு	களை என்பதன் பொருள் புல் பூண்டு	RWE_M	0
கலை என்பதன் பொருள் புல் பூண்டு	களை என்பதன் பொருள் புல் பூண்டு	RWE_M	0
கழை என்பதன் பொருள் அயர்வு	களை என்பதன் பொருள் அயர்வு	RWE_M	0
கலை என்பதன் பொருள் அயர்வு	களை என்பதன் பொருள் அயர்வு	RWE_M	0
கள் என்பதன் பொருள் மலை	கல் என்பதன் பொருள் மலை	RWE_M	0
கள் என்பதன் பொருள் பாறை	கல் என்பதன் பொருள் பாறை	RWE_M	0
கள் என்பதன் பொருள் சிறுகல்	கல் என்பதன் பொருள் சிறுகல்	RWE_M	0
கல் என்பதன் பொருள் மது	கள் என்பதன் பொருள் மது	RWE_M	0
கல் என்பதன் பொருள் தேன்	கள் என்பதன் பொருள் தேன்	RWE_M	0
களம் என்பதன் பொருள் கப்பல்	கலம் என்பதன் பொருள் கப்பல்	RWE_M	0
களம் என்பதன் பொருள் கப்பல் பாத்திரம்	கலம் என்பதன் பொருள் கப்பல் பாத்திரம்	RWE_M	0
கலம் என்பதன் பொருள் இடம்	களம் என்பதன் பொருள் இடம்	RWE_M	0
கலம் என்பதன் பொருள் போர்க்களம்	களம் என்பதன் பொருள் போர்க்களம்	RWE_M	0
கலம் என்பதன் பொருள் இருள்	களம் என்பதன் பொருள் இருள்	RWE_M	0
காளி என்பதன் பொருள் ஒன்றுமில்லாதது	காலி என்பதன் பொருள் ஒன்றுமில்லாதது	RWE_M	0
காழி என்பதன் பொருள் ஒன்றுமில்லாதது	காலி என்பதன் பொருள் ஒன்றுமில்லாதது	RWE_M	0
காளி என்பதன் பொருள் வெற்றிடம்	காலி என்பதன் பொருள் வெற்றிடம்	RWE_M	0
காழி என்பதன் பொருள் வெற்றிடம்	காலி என்பதன் பொருள் வெற்றிடம்	RWE_M	0
காலி என்பதன் பொருள் துர்க்கை	காளி என்பதன் பொருள் துர்க்கை	RWE_M	0
காழி என்பதன் பொருள் துர்க்கை	காளி என்பதன் பொருள் துர்க்கை	RWE_M	0
காலி என்பதன் பொருள் மாயை	காளி என்பதன் பொருள் மாயை	RWE_M	0
காழி என்பதன் பொருள் மாயை	காளி என்பதன் பொருள் மாயை	RWE_M	0
காளி என்பதன் பொருள் சீர்காழி (ஊர்)	காழி என்பதன் பொருள் சீர்காழி (ஊர்)	RWE_M	0
காலி என்பதன் பொருள் சீர்காழி (ஊர்)	காழி என்பதன் பொருள் சீர்காழி (ஊர்)	RWE_M	0
காளை என்பதன் பொருள் பொழுது	காலை என்பதன் பொருள் பொழுது	RWE_M	0
காளை என்பதன் பொருள் விடியற்பொழுது	காலை என்பதன் பொருள் விடியற்பொழுது	RWE_M	0
காலை என்பதன் பொருள் காளைமாடு	காளை என்பதன் பொருள் காளைமாடு	RWE_M	0
காலை என்பதன் பொருள் இளைஞன்	காளை என்பதன் பொருள் இளைஞன்	RWE_M	0
காளம் என்பதன் பொருள் பொழுது	காலம் என்பதன் பொருள் பொழுது	RWE_M	0
காளம் என்பதன் பொருள் நேரம்	காலம் என்பதன் பொருள் நேரம்	RWE_M	0
காலம் என்பதன் பொருள் எட்டிமரம்	காளம் என்பதன் பொருள் எட்டிமரம்	RWE_M	0
காலம் என்பதன் பொருள் சூலம்	காளம் என்பதன் பொருள் சூலம்	RWE_M	0
கிழி என்பதன் பொருள் அச்சம்	கிலி என்பதன் பொருள் அச்சம்	RWE_M	0
கிளி என்பதன் பொருள் அச்சம்	கிலி என்பதன் பொருள் அச்சம்	RWE_M	0
கிழி என்பதன் பொருள் பயம்	கிலி என்பதன் பொருள் பயம்	RWE_M	0
கிளி என்பதன் பொருள் பயம்	கிலி என்பதன் பொருள் பயம்	RWE_M	0
கிளி என்பதன் பொருள் கிழித்துவிடு	கிழி என்பதன் பொருள் கிழித்துவிடு	RWE_M	0
கிலி என்பதன் பொருள் கிழித்துவிடு	கிழி என்பதன் பொருள் கிழித்துவிடு	RWE_M	0
கிளி என்பதன் பொருள் முடிப்பு (பொன்)	கிழி என்பதன் பொருள் முடிப்பு (பொன்)	RWE_M	0
கிலி என்பதன் பொருள் முடிப்பு (பொன்)	கிழி என்பதன் பொருள் முடிப்பு (பொன்)	RWE_M	0
கிலி என்பதன் பொருள் பறவை	கிளி என்பதன் பொருள் பறவை	RWE_M	0
கிழி என்பதன் பொருள் பறவை	கிளி என்பதன் பொருள் பறவை	RWE_M	0
கிலி என்பதன் பொருள் வெட்டுக்கிளி	கிளி என்பதன் பொருள் வெட்டுக்கிளி	RWE_M	0
கிழி என்பதன் பொருள் வெட்டுக்கிளி	கிளி என்பதன் பொருள் வெட்டுக்கிளி	RWE_M	0
கிளவி என்பதன் பொருள் முதியவள் 	கிழவி என்பதன் பொருள் முதியவள் 	RWE_M	0
கிளவி என்பதன் பொருள் மூதாட்டி	கிழவி என்பதன் பொருள் மூதாட்டி	RWE_M	0
கிழவி என்பதன் பொருள் சொல்	கிளவி என்பதன் பொருள் சொல்	RWE_M	0
கிழவி என்பதன் பொருள் மொழி	கிளவி என்பதன் பொருள் மொழி	RWE_M	0
குழி என்பதன் பொருள் மனைவி	குலி என்பதன் பொருள் மனைவி	RWE_M	0
குளி என்பதன் பொருள் மனைவி	குலி என்பதன் பொருள் மனைவி	RWE_M	0
குளி என்பதன் பொருள் பள்ளம்	குழி என்பதன் பொருள் பள்ளம்	RWE_M	0
குலி என்பதன் பொருள் பள்ளம்	குழி என்பதன் பொருள் பள்ளம்	RWE_M	0
குளி என்பதன் பொருள் பாத்தி	குழி என்பதன் பொருள் பாத்தி	RWE_M	0
குலி என்பதன் பொருள் பாத்தி	குழி என்பதன் பொருள் பாத்தி	RWE_M	0
குளி என்பதன் பொருள் பன்னீரடிச் சதுரம்	குழி என்பதன் பொருள் பன்னீரடிச் சதுரம்	RWE_M	0
குலி என்பதன் பொருள் பன்னீரடிச் சதுரம்	குழி என்பதன் பொருள் பன்னீரடிச் சதுரம்	RWE_M	0
குளி என்பதன் பொருள் வயிறு	குழி என்பதன் பொருள் வயிறு	RWE_M	0
குலி என்பதன் பொருள் வயிறு	குழி என்பதன் பொருள் வயிறு	RWE_M	0
குலி என்பதன் பொருள் நீராடு	குளி என்பதன் பொருள் நீராடு	RWE_M	0
குழி என்பதன் பொருள் நீராடு	குளி என்பதன் பொருள் நீராடு	RWE_M	0
குளம் என்பதன் பொருள் ஜாதியின் உட்பிரிவு	குலம் என்பதன் பொருள் ஜாதியின் உட்பிரிவு	RWE_M	0
குளம் என்பதன் பொருள் இனம்	குலம் என்பதன் பொருள் இனம்	RWE_M	0
குளம் என்பதன் பொருள் குடி	குலம் என்பதன் பொருள் குடி	RWE_M	0
குலம் என்பதன் பொருள் நீர்நிலை	குளம் என்பதன் பொருள் நீர்நிலை	RWE_M	0
குலம் என்பதன் பொருள் கண்மாய்	குளம் என்பதன் பொருள் கண்மாய்	RWE_M	0
குலம் என்பதன் பொருள் ஏரி	குளம் என்பதன் பொருள் ஏரி	RWE_M	0
குழை என்பதன் பொருள் கொத்து	குலை என்பதன் பொருள் கொத்து	RWE_M	0
குழை என்பதன் பொருள் மனம் தடுமாறுதல்	குலை என்பதன் பொருள் மனம் தடுமாறுதல்	RWE_M	0
குலை என்பதன் பொருள் குண்டலம்	குழை என்பதன் பொருள் குண்டலம்	RWE_M	0
குலை என்பதன் பொருள் குழைந்துபோதல்	குழை என்பதன் பொருள் குழைந்துபோதல்	RWE_M	0
குழவி என்பதன் பொருள் மகிழ்ந்திருத்தல்	குலவி என்பதன் பொருள் மகிழ்ந்திருத்தல்	RWE_M	0
குளவி என்பதன் பொருள் மகிழ்ந்திருத்தல்	குலவி என்பதன் பொருள் மகிழ்ந்திருத்தல்	RWE_M	0
குலவி என்பதன் பொருள் குழந்தை	குழவி என்பதன் பொருள் குழந்தை	RWE_M	0
குளவி என்பதன் பொருள் குழந்தை	குழவி என்பதன் பொருள் குழந்தை	RWE_M	0
குளவி என்பதன் பொருள் இளமை	குழவி என்பதன் பொருள் இளமை	RWE_M	0
குலவி என்பதன் பொருள் இளமை	குழவி என்பதன் பொருள் இளமை	RWE_M	0
குளவி என்பதன் பொருள் யானைக் கன்று 	குழவி என்பதன் பொருள் யானைக் கன்று 	RWE_M	0
குலவி என்பதன் பொருள் யானைக் கன்று 	குழவி என்பதன் பொருள் யானைக் கன்று 	RWE_M	0
குளவி என்பதன் பொருள் அம்மிக்கல்	குழவி என்பதன் பொருள் அம்மிக்கல்	RWE_M	0
குலவி என்பதன் பொருள் அம்மிக்கல்	குழவி என்பதன் பொருள் அம்மிக்கல்	RWE_M	0
குலவி ஒரு வண்டு	குளவி ஒரு வண்டு	RWE_M	0
குழவி ஒரு வண்டு	குளவி ஒரு வண்டு	RWE_M	0
குழவி என்பதன் பொருள் காட்டுமல்லி	குளவி என்பதன் பொருள் காட்டுமல்லி	RWE_M	0
குலவி என்பதன் பொருள் காட்டுமல்லி	குளவி என்பதன் பொருள் காட்டுமல்லி	RWE_M	0
குளிகம் என்பதன் பொருள் சிவப்பு	குலிகம் என்பதன் பொருள் சிவப்பு	RWE_M	0
குளிகம் என்பதன் பொருள் இலுப்பை	குலிகம் என்பதன் பொருள் இலுப்பை	RWE_M	0
குலிகம் என்பதன் பொருள் மருந்து	குளிகம் என்பதன் பொருள் மருந்து	RWE_M	0
குலிகம் என்பதன் பொருள் மாத்திரை	குளிகம் என்பதன் பொருள் மாத்திரை	RWE_M	0
குவளை என்பதன் பொருள் துளசி	குவலை என்பதன் பொருள் துளசி	RWE_M	0
குவளை என்பதன் பொருள் கஞ்சா	குவலை என்பதன் பொருள் கஞ்சா	RWE_M	0
குவலை என்பதன் பொருள் குவளை மலர்	குவளை என்பதன் பொருள் குவளை மலர்	RWE_M	0
குவலை என்பதன் பொருள் சொம்பு	குவளை என்பதன் பொருள் சொம்பு	RWE_M	0
குவலை என்பதன் பொருள் ஒரு பேரெண்	குவளை என்பதன் பொருள் ஒரு பேரெண்	RWE_M	0
கூளம் என்பதன் பொருள் தானியம்	கூலம் என்பதன் பொருள் தானியம்	RWE_M	0
கூளம் என்பதன் பொருள் கடைத்தெரு	கூலம் என்பதன் பொருள் கடைத்தெரு	RWE_M	0
கூலம் என்பதன் பொருள் குப்பை	கூளம் என்பதன் பொருள் குப்பை	RWE_M	0
கூளி என்பதன் பொருள் ஊதியம்	கூலி என்பதன் பொருள் ஊதியம்	RWE_M	0
கூலி என்பதன் பொருள் பேய்	கூளி என்பதன் பொருள் பேய்	RWE_M	0
கூலி என்பதன் பொருள் காளை	கூளி என்பதன் பொருள் காளை	RWE_M	0
கூலி என்பதன் பொருள் வீரர்	கூளி என்பதன் பொருள் வீரர்	RWE_M	0
கூலி என்பதன் பொருள் படைவீரர்	கூளி என்பதன் பொருள் படைவீரர்	RWE_M	0
கூலி என்பதன் பொருள் வணங்கி நிற்பவர்	கூளி என்பதன் பொருள் வணங்கி நிற்பவர்	RWE_M	0
கூலி என்பதன் பொருள் ஏவலாளர்	கூளி என்பதன் பொருள் ஏவலாளர்	RWE_M	0
கொழு என்பதன் பொருள் அரசசபை	கொலு என்பதன் பொருள் அரசசபை	RWE_M	0
கொளு என்பதன் பொருள் அரசசபை	கொலு என்பதன் பொருள் அரசசபை	RWE_M	0
கொழு என்பதன் பொருள் தெய்வசபை	கொலு என்பதன் பொருள் தெய்வசபை	RWE_M	0
கொளு என்பதன் பொருள் தெய்வசபை	கொலு என்பதன் பொருள் தெய்வசபை	RWE_M	0
கொழு என்பதன் பொருள் உல்லாசமாக வீற்றிருத்தல்	கொலு என்பதன் பொருள் உல்லாசமாக வீற்றிருத்தல்	RWE_M	0
கொளு என்பதன் பொருள் உல்லாசமாக வீற்றிருத்தல்	கொலு என்பதன் பொருள் உல்லாசமாக வீற்றிருத்தல்	RWE_M	0
கொளு என்பதன் பொருள் மழு	கொழு என்பதன் பொருள் மழு	RWE_M	0
கொலு என்பதன் பொருள் மழு	கொழு என்பதன் பொருள் மழு	RWE_M	0
கொலு என்பதன் பொருள் கொழுத்து இருத்தல்	கொழு என்பதன் பொருள் கொழுத்து இருத்தல்	RWE_M	0
கொளு என்பதன் பொருள் கொழுத்து இருத்தல்	கொழு என்பதன் பொருள் கொழுத்து இருத்தல்	RWE_M	0
கொளு என்பதன் பொருள் கலப்பையில் மாட்டும் பெரிய இரும்பு 	கொழு என்பதன் பொருள் கலப்பையில் மாட்டும் பெரிய இரும்பு 	RWE_M	0
கொலு என்பதன் பொருள் கலப்பையில் மாட்டும் பெரிய இரும்பு	கொழு என்பதன் பொருள் கலப்பையில் மாட்டும் பெரிய இரும்பு 	RWE_M	0
கொலு என்பதன் பொருள் புறப்பொருள் வெண்பாமாலைத் துறை 	கொளு என்பதன் பொருள் புறப்பொருள் வெண்பாமாலைத் துறை 	RWE_M	0
கொழு என்பதன் பொருள் புறப்பொருள் வெண்பாமாலைத் துறை 	கொளு என்பதன் பொருள் புறப்பொருள் வெண்பாமாலைத் துறை 	RWE_M	0
கொலு என்பதன் பொருள் பொருந்துவாய்	கொளு என்பதன் பொருள் பொருந்துவாய்	RWE_M	0
கொழு என்பதன் பொருள் பொருந்துவாய்	கொளு என்பதன் பொருள் பொருந்துவாய்	RWE_M	0
கொளை என்பதன் பொருள் கொல்லுதல்	கொலை என்பதன் பொருள் கொல்லுதல்	RWE_M	0
கொலை என்பதன் பொருள் கோட்பாடு	கொளை என்பதன் பொருள் கோட்பாடு	RWE_M	0
கொலை என்பதன் பொருள் பயன்	கொளை என்பதன் பொருள் பயன்	RWE_M	0
கொலை என்பதன் பொருள் இசைப்பாட்டு	கொளை என்பதன் பொருள் இசைப்பாட்டு	RWE_M	0
கொலை என்பதன் பொருள் தாளம்	கொளை என்பதன் பொருள் தாளம்	RWE_M	0
கொள்ளாமை என்பதன் பொருள் கொலை செய்யாமை	கொல்லாமை என்பதன் பொருள் கொலை செய்யாமை	RWE_M	0
கொல்லாமை என்பதன் பொருள் ஏற்றுக் கொள்ளாமை	கொள்ளாமை என்பதன் பொருள் ஏற்றுக் கொள்ளாமை	RWE_M	0
கொல்லாமை என்பதன் பொருள் அடங்காமை	கொள்ளாமை என்பதன் பொருள் அடங்காமை	RWE_M	0
கொள்ளி என்பதன் பொருள் உயிர்க்கொல்லி	கொல்லி என்பதன் பொருள் உயிர்க்கொல்லி	RWE_M	0
கொள்ளி ஒரு மலை	கொல்லி ஒரு மலை	RWE_M	0
கொல்லி என்பதன் பொருள் கொள்ளிக்கட்டை	கொள்ளி என்பதன் பொருள் கொள்ளிக்கட்டை	RWE_M	0
கொள்ளை என்பதன் பொருள் புழக்கடை	கொல்லை என்பதன் பொருள் புழக்கடை	RWE_M	0
கொள்ளை என்பதன் பொருள் தரிசுநிலம்	கொல்லை என்பதன் பொருள் தரிசுநிலம்	RWE_M	0
கொல்லை என்பதன் பொருள் திருடுதல்	கொள்ளை என்பதன் பொருள் திருடுதல்	RWE_M	0
கொல்லை என்பதன் பொருள் மிகுதி	கொள்ளை என்பதன் பொருள் மிகுதி	RWE_M	0
கோளம் என்பதன் பொருள் அழகு	கோலம் என்பதன் பொருள் அழகு	RWE_M	0
கோளம் என்பதன் பொருள் அலங்காரம்	கோலம் என்பதன் பொருள் அலங்காரம்	RWE_M	0
கோலம் என்பதன் பொருள் உருண்டை	கோளம் என்பதன் பொருள் உருண்டை	RWE_M	0
கோலம் என்பதன் பொருள் வட்டம்	கோளம் என்பதன் பொருள் வட்டம்	RWE_M	0
கோழை என்பதன் பொருள் மிளகு	கோலை என்பதன் பொருள் மிளகு	RWE_M	0
கோளை என்பதன் பொருள் மிளகு	கோலை என்பதன் பொருள் மிளகு	RWE_M	0
கோலை என்பதன் பொருள் வீரமற்றவன்	கோழை என்பதன் பொருள் வீரமற்றவன்	RWE_M	0
கோளை என்பதன் பொருள் வீரமற்றவன்	கோழை என்பதன் பொருள் வீரமற்றவன்	RWE_M	0
கோலை என்பதன் பொருள் கபம்	கோழை என்பதன் பொருள் கபம்	RWE_M	0
கோளை என்பதன் பொருள் கபம்	கோழை என்பதன் பொருள் கபம்	RWE_M	0
கோழை என்பதன் பொருள் குவளை	கோளை என்பதன் பொருள் குவளை	RWE_M	0
கோலை என்பதன் பொருள் குவளை	கோளை என்பதன் பொருள் குவளை	RWE_M	0
கோழை என்பதன் பொருள் எலி	கோளை என்பதன் பொருள் எலி	RWE_M	0
கோலை என்பதன் பொருள் எலி	கோளை என்பதன் பொருள் எலி	RWE_M	0
கோள் என்பதன் பொருள் மரக்கொம்பு	கோல் என்பதன் பொருள் மரக்கொம்பு	RWE_M	0
கோள் என்பதன் பொருள் அம்பு	கோல் என்பதன் பொருள் அம்பு	RWE_M	0
கோள் என்பதன் பொருள் குதிரைச்சம்மட்டி	கோல் என்பதன் பொருள் குதிரைச்சம்மட்டி	RWE_M	0
கோள் என்பதன் பொருள் தண்டு	கோல் என்பதன் பொருள் தண்டு	RWE_M	0
கோள் என்பதன் பொருள் யாழ்நரம்பு	கோல் என்பதன் பொருள் யாழ்நரம்பு	RWE_M	0
கோல் என்பதன் பொருள் கிரகம்	கோள் என்பதன் பொருள் கிரகம்	RWE_M	0
கோளி என்பதன் பொருள் இலந்தை	கோலி என்பதன் பொருள் இலந்தை	RWE_M	0
கோழி என்பதன் பொருள் இலந்தை	கோலி என்பதன் பொருள் இலந்தை	RWE_M	0
கோளி என்பதன் பொருள் விளையாடும் குண்டு	கோலி என்பதன் பொருள் விளையாடும் குண்டு	RWE_M	0
கோழி என்பதன் பொருள் விளையாடும் குண்டு	கோலி என்பதன் பொருள் விளையாடும் குண்டு	RWE_M	0
கோளி என்பதன் பொருள் உறையூர்	கோழி என்பதன் பொருள் உறையூர்	RWE_M	0
கோலி என்பதன் பொருள் உறையூர்	கோழி என்பதன் பொருள் உறையூர்	RWE_M	0
கோளி என்பதன் பொருள் விட்டில்	கோழி என்பதன் பொருள் விட்டில்	RWE_M	0
கோலி என்பதன் பொருள் விட்டில்	கோழி என்பதன் பொருள் விட்டில்	RWE_M	0
கோளி என்பதன் பொருள் பறவை	கோழி என்பதன் பொருள் பறவை	RWE_M	0
கோலி என்பதன் பொருள் பறவை	கோழி என்பதன் பொருள் பறவை	RWE_M	0
கோழி என்பதன் பொருள் பூவாது காய்க்கும் மரம்	கோளி என்பதன் பொருள் பூவாது காய்க்கும் மரம்	RWE_M	0
கோலி என்பதன் பொருள் பூவாது காய்க்கும் மரம்	கோளி என்பதன் பொருள் பூவாது காய்க்கும் மரம்	RWE_M	0
கோழி என்பதன் பொருள் ஆத்தி	கோளி என்பதன் பொருள் ஆத்தி	RWE_M	0
கோலி என்பதன் பொருள் ஆத்தி	கோளி என்பதன் பொருள் ஆத்தி	RWE_M	0
கோழி என்பதன் பொருள் ஆலம்	கோளி என்பதன் பொருள் ஆலம்	RWE_M	0
கோலி என்பதன் பொருள் ஆலம்	கோளி என்பதன் பொருள் ஆலம்	RWE_M	0
சளம் என்பதன் பொருள் நீர்	சலம் என்பதன் பொருள் நீர்	RWE_M	0
சளம் என்பதன் பொருள் சிறுநீர்	சலம் என்பதன் பொருள் சிறுநீர்	RWE_M	0
சளம் என்பதன் பொருள் குளிர்	சலம் என்பதன் பொருள் குளிர்	RWE_M	0
சலம் என்பதன் பொருள் பொய்	சளம் என்பதன் பொருள் பொய்	RWE_M	0
சலம் என்பதன் பொருள் துன்பம்	சளம் என்பதன் பொருள் துன்பம்	RWE_M	0
சலம் என்பதன் பொருள் வஞ்சனை	சளம் என்பதன் பொருள் வஞ்சனை	RWE_M	0
சாளை என்பதன் பொருள் பாடசாலை	சாலை என்பதன் பொருள் பாடசாலை	RWE_M	0
சாழை என்பதன் பொருள் பாடசாலை	சாலை என்பதன் பொருள் பாடசாலை	RWE_M	0
சாளை என்பதன் பொருள் பொது மண்டபம்	சாலை என்பதன் பொருள் பொது மண்டபம்	RWE_M	0
சாழை என்பதன் பொருள் பொது மண்டபம்	சாலை என்பதன் பொருள் பொது மண்டபம்	RWE_M	0
சாளை என்பதன் பொருள் அறக்கூடம்	சாலை என்பதன் பொருள் அறக்கூடம்	RWE_M	0
சாழை என்பதன் பொருள் அறக்கூடம்	சாலை என்பதன் பொருள் அறக்கூடம்	RWE_M	0
சாலை என்பதன் பொருள் கடல்மீன்	சாளை என்பதன் பொருள் கடல்மீன்	RWE_M	0
சாழை என்பதன் பொருள் கடல்மீன்	சாளை என்பதன் பொருள் கடல்மீன்	RWE_M	0
சாலை என்பதன் பொருள் குடிசை	சாழை என்பதன் பொருள் குடிசை	RWE_M	0
சாளை என்பதன் பொருள் குடிசை	சாழை என்பதன் பொருள் குடிசை	RWE_M	0
சாலை என்பதன் பொருள் குச்சு	சாழை என்பதன் பொருள் குச்சு	RWE_M	0
சாளை என்பதன் பொருள் குச்சு	சாழை என்பதன் பொருள் குச்சு	RWE_M	0
சுளித்தல் என்பதன் பொருள் சுழலுதல்	சுழித்தல் என்பதன் பொருள் சுழலுதல்	RWE_M	0
சுளித்தல் என்பதன் பொருள் நீர்ச்சுழல்	சுழித்தல் என்பதன் பொருள் நீர்ச்சுழல்	RWE_M	0
சுழித்தல் என்பதன் பொருள் முறித்தல்	சுளித்தல் என்பதன் பொருள் முறித்தல்	RWE_M	0
சுழித்தல் என்பதன் பொருள் சினத்தல்	சுளித்தல் என்பதன் பொருள் சினத்தல்	RWE_M	0
சூளை என்பதன் பொருள் வயிற்று நோய்	சூலை என்பதன் பொருள் வயிற்று நோய்	RWE_M	0
சூலை என்பதன் பொருள் செங்கல் சூளை	சூளை என்பதன் பொருள் செங்கல் சூளை	RWE_M	0
சூழ் என்பதன் பொருள் கர்ப்பம்	சூல் என்பதன் பொருள் கர்ப்பம்	RWE_M	0
சூள் என்பதன் பொருள் கர்ப்பம்	சூல் என்பதன் பொருள் கர்ப்பம்	RWE_M	0
சூள் என்பதன் பொருள் சூழ்ந்துகொள்	சூழ் என்பதன் பொருள் சூழ்ந்துகொள்	RWE_M	0
சூல் என்பதன் பொருள் சூழ்ந்துகொள்	சூழ் என்பதன் பொருள் சூழ்ந்துகொள்	RWE_M	0
சூள் என்பதன் பொருள் சுற்று	சூழ் என்பதன் பொருள் சுற்று	RWE_M	0
சூல் என்பதன் பொருள் சுற்று	சூழ் என்பதன் பொருள் சுற்று	RWE_M	0
சூல் என்பதன் பொருள் சபதம்	சூள் என்பதன் பொருள் சபதம்	RWE_M	0
சூழ் என்பதன் பொருள் சபதம்	சூள் என்பதன் பொருள் சபதம்	RWE_M	0
சேள் என்பதன் பொருள் மீன்	சேல் என்பதன் பொருள் மீன்	RWE_M	0
சேல் என்பதன் பொருள் மேலிடம்	சேள் என்பதன் பொருள் மேலிடம்	RWE_M	0
சோழி என்பதன் பொருள் ரவிக்கை	சோலி என்பதன் பொருள் ரவிக்கை	RWE_M	0
சோளி என்பதன் பொருள் ரவிக்கை	சோலி என்பதன் பொருள் ரவிக்கை	RWE_M	0
சோழி என்பதன் பொருள் காரியம்	சோலி என்பதன் பொருள் காரியம்	RWE_M	0
சோளி என்பதன் பொருள் காரியம்	சோலி என்பதன் பொருள் காரியம்	RWE_M	0
சோளி என்பதன் பொருள் பலகரை	சோழி என்பதன் பொருள் பலகரை	RWE_M	0
சோலி என்பதன் பொருள் பலகரை	சோழி என்பதன் பொருள் பலகரை	RWE_M	0
சோலி என்பதன் பொருள் கூடைவகை	சோளி என்பதன் பொருள் கூடைவகை	RWE_M	0
சோழி என்பதன் பொருள் கூடைவகை	சோளி என்பதன் பொருள் கூடைவகை	RWE_M	0
தவலை என்பதன் பொருள் ஓர் உயிரி	தவளை என்பதன் பொருள் ஓர் உயிரி	RWE_M	0
தவளை என்பதன் பொருள் பாத்திரம்	தவலை என்பதன் பொருள் பாத்திரம்	RWE_M	0
தழம் என்பதன் பொருள் இடம்	தலம் என்பதன் பொருள் இடம்	RWE_M	0
தளம் என்பதன் பொருள் இடம்	தலம் என்பதன் பொருள் இடம்	RWE_M	0
தழம் என்பதன் பொருள் பூமி	தலம் என்பதன் பொருள் பூமி	RWE_M	0
தளம் என்பதன் பொருள் பூமி	தலம் என்பதன் பொருள் பூமி	RWE_M	0
தளம் என்பதன் பொருள் தைலம்	தழம் என்பதன் பொருள் தைலம்	RWE_M	0
தலம் என்பதன் பொருள் தைலம்	தழம் என்பதன் பொருள் தைலம்	RWE_M	0
தலம் என்பதன் பொருள் மேடை	தளம் என்பதன் பொருள் மேடை	RWE_M	0
தழம் என்பதன் பொருள் மேடை	தளம் என்பதன் பொருள் மேடை	RWE_M	0
தழம் என்பதன் பொருள் மாடி வீட்டின் அடுக்கு	தளம் என்பதன் பொருள் மாடி வீட்டின் அடுக்கு	RWE_M	0
தலம் என்பதன் பொருள் மாடி வீட்டின் அடுக்கு	தளம் என்பதன் பொருள் மாடி வீட்டின் அடுக்கு	RWE_M	0
தளை என்பதன் பொருள் தாவர உறுப்பு	தழை என்பதன் பொருள் தாவர உறுப்பு	RWE_M	0
தலை என்பதன் பொருள் தாவர உறுப்பு	தழை என்பதன் பொருள் தாவர உறுப்பு	RWE_M	0
தளை என்பதன் பொருள் மண்டை	தலை என்பதன் பொருள் மண்டை	RWE_M	0
தழை என்பதன் பொருள் மண்டை	தலை என்பதன் பொருள் மண்டை	RWE_M	0
தலை என்பதன் பொருள் விலங்கு	தளை என்பதன் பொருள் விலங்கு	RWE_M	0
தழை என்பதன் பொருள் விலங்கு	தளை என்பதன் பொருள் விலங்கு	RWE_M	0
தாளம் என்பதன் பொருள் உலகம்	தாலம் என்பதன் பொருள் உலகம்	RWE_M	0
தாளம் என்பதன் பொருள் தேன்	தாலம் என்பதன் பொருள் தேன்	RWE_M	0
தாலம் என்பதன் பொருள் இசைக்கருவி	தாளம் என்பதன் பொருள் இசைக்கருவி	RWE_M	0
தாலம் என்பதன் பொருள் ஜதி	தாளம் என்பதன் பொருள் ஜதி	RWE_M	0
தாழி என்பதன் பொருள் மங்கலநாண்	தாலி என்பதன் பொருள் மங்கலநாண்	RWE_M	0
தாளி என்பதன் பொருள் மங்கலநாண்	தாலி என்பதன் பொருள் மங்கலநாண்	RWE_M	0
தாளி என்பதன் பொருள் கடல்	தாழி என்பதன் பொருள் கடல்	RWE_M	0
தாலி என்பதன் பொருள் கடல்	தாழி என்பதன் பொருள் கடல்	RWE_M	0
தாளி என்பதன் பொருள் குடம்	தாழி என்பதன் பொருள் குடம்	RWE_M	0
தாலி என்பதன் பொருள் குடம்	தாழி என்பதன் பொருள் குடம்	RWE_M	0
தாளி என்பதன் பொருள் பரணி 	தாழி என்பதன் பொருள் பரணி 	RWE_M	0
தாலி என்பதன் பொருள் பரணி 	தாழி என்பதன் பொருள் பரணி 	RWE_M	0
தாளி என்பதன் பொருள் பெரியபாண்டம்	தாழி என்பதன் பொருள் பெரியபாண்டம்	RWE_M	0
தாலி என்பதன் பொருள் பெரியபாண்டம்	தாழி என்பதன் பொருள் பெரியபாண்டம்	RWE_M	0
தாலி என்பதன் பொருள் தாளித்தல்	தாளி என்பதன் பொருள் தாளித்தல்	RWE_M	0
தாழி என்பதன் பொருள் தாளித்தல்	தாளி என்பதன் பொருள் தாளித்தல்	RWE_M	0
தாலி என்பதன் பொருள் நாக்கு	தாளி என்பதன் பொருள் நாக்கு	RWE_M	0
தாழி என்பதன் பொருள் நாக்கு	தாளி என்பதன் பொருள் நாக்கு	RWE_M	0
தாலி என்பதன் பொருள் தாலாட்டு	தாளி என்பதன் பொருள் தாலாட்டு	RWE_M	0
தாழி என்பதன் பொருள் தாலாட்டு	தாளி என்பதன் பொருள் தாலாட்டு	RWE_M	0
தாள் என்பதன் பொருள் தாழ்தல்	தாழ் என்பதன் பொருள் தாழ்தல்	RWE_M	0
தாள் என்பதன் பொருள் குனிதல்	தாழ் என்பதன் பொருள் குனிதல்	RWE_M	0
தாழ் என்பதன் பொருள் முயற்சி	தாள் என்பதன் பொருள் முயற்சி	RWE_M	0
தாழ் என்பதன் பொருள் பாதம்	தாள் என்பதன் பொருள் பாதம்	RWE_M	0
தாழ் என்பதன் பொருள் ஆதி	தாள் என்பதன் பொருள் ஆதி	RWE_M	0
தாழ் என்பதன் பொருள் படி	தாள் என்பதன் பொருள் படி	RWE_M	0
தாழ் என்பதன் பொருள் காகிதம்	தாள் என்பதன் பொருள் காகிதம்	RWE_M	0
துளக்கம் என்பதன் பொருள் ஒளி	துலக்கம் என்பதன் பொருள் ஒளி	RWE_M	0
துளக்கம் என்பதன் பொருள் தெளிவு	துலக்கம் என்பதன் பொருள் தெளிவு	RWE_M	0
துலக்கம் என்பதன் பொருள் அசைவு	துளக்கம் என்பதன் பொருள் அசைவு	RWE_M	0
துலக்கம் என்பதன் பொருள் வருத்தம்	துளக்கம் என்பதன் பொருள் வருத்தம்	RWE_M	0
துலக்கம் என்பதன் பொருள் கலக்கம்	துளக்கம் என்பதன் பொருள் கலக்கம்	RWE_M	0
துலக்கம் என்பதன் பொருள் ஒளி	துளக்கம் என்பதன் பொருள் ஒளி	RWE_M	0
துளம் என்பதன் பொருள் கோரை	துலம் என்பதன் பொருள் கோரை	RWE_M	0
துளம் என்பதன் பொருள் கனம்	துலம் என்பதன் பொருள் கனம்	RWE_M	0
துலம் என்பதன் பொருள் மாதுளை	துளம் என்பதன் பொருள் மாதுளை	RWE_M	0
துலம் என்பதன் பொருள் மயிலிறகு	துளம் என்பதன் பொருள் மயிலிறகு	RWE_M	0
துழி என்பதன் பொருள் பெண் ஆமை	துலி என்பதன் பொருள் பெண் ஆமை	RWE_M	0
துளி என்பதன் பொருள் பெண் ஆமை	துலி என்பதன் பொருள் பெண் ஆமை	RWE_M	0
துளி என்பதன் பொருள் பள்ளம்	துழி என்பதன் பொருள் பள்ளம்	RWE_M	0
துலி என்பதன் பொருள் பள்ளம்	துழி என்பதன் பொருள் பள்ளம்	RWE_M	0
துழி என்பதன் பொருள் மழைத்துளி	துளி என்பதன் பொருள் மழைத்துளி	RWE_M	0
துலி என்பதன் பொருள் மழைத்துளி	துளி என்பதன் பொருள் மழைத்துளி	RWE_M	0
துழி என்பதன் பொருள் திவலை	துளி என்பதன் பொருள் திவலை	RWE_M	0
துலி என்பதன் பொருள் திவலை	துளி என்பதன் பொருள் திவலை	RWE_M	0
துழி என்பதன் பொருள் சிறிய அளவு	துளி என்பதன் பொருள் சிறிய அளவு	RWE_M	0
துலி என்பதன் பொருள் சிறிய அளவு	துளி என்பதன் பொருள் சிறிய அளவு	RWE_M	0
துளை என்பதன் பொருள் ஒப்பு	துலை என்பதன் பொருள் ஒப்பு	RWE_M	0
துளை என்பதன் பொருள் கனம்	துலை என்பதன் பொருள் கனம்	RWE_M	0
துலை என்பதன் பொருள் துவாரம்	துளை என்பதன் பொருள் துவாரம்	RWE_M	0
துலை என்பதன் பொருள் வாயில்	துளை என்பதன் பொருள் வாயில்	RWE_M	0
தூளி என்பதன் பொருள் எழுதுகோல்	தூலி என்பதன் பொருள் எழுதுகோல்	RWE_M	0
தூளி என்பதன் பொருள் எழுத்தாணி	தூலி என்பதன் பொருள் எழுத்தாணி	RWE_M	0
தூலி என்பதன் பொருள் புழுதி	தூளி என்பதன் பொருள் புழுதி	RWE_M	0
தூலி என்பதன் பொருள் குதிரை	தூளி என்பதன் பொருள் குதிரை	RWE_M	0
தெளித்தல் என்பதன் பொருள் கோபித்தல்	தெழித்தல் என்பதன் பொருள் கோபித்தல்	RWE_M	0
தெளித்தல் என்பதன் பொருள் முழங்குதல்	தெழித்தல் என்பதன் பொருள் முழங்குதல்	RWE_M	0
தெளித்தல் என்பதன் பொருள் அதட்டுதல்	தெழித்தல் என்பதன் பொருள் அதட்டுதல்	RWE_M	0
தெளித்தல் என்பதன் பொருள் நீக்குதல்	தெழித்தல் என்பதன் பொருள் நீக்குதல்	RWE_M	0
தெளித்தல் என்பதன் பொருள் ஆரவாரித்தல்	தெழித்தல் என்பதன் பொருள் ஆரவாரித்தல்	RWE_M	0
தெழித்தல் என்பதன் பொருள் விதைத்தல்	தெளித்தல் என்பதன் பொருள் விதைத்தல்	RWE_M	0
தெழித்தல் என்பதன் பொருள் சபதம்	தெளித்தல் என்பதன் பொருள் சபதம்	RWE_M	0
தெழித்தல் என்பதன் பொருள் கூறல்	தெளித்தல் என்பதன் பொருள் கூறல்	RWE_M	0
தெள் என்பதன் பொருள் அஞ்சுதல்	தெல் என்பதன் பொருள் அஞ்சுதல்	RWE_M	0
தெல் என்பதன் பொருள் தெளிவான	தெள் என்பதன் பொருள் தெளிவான	RWE_M	0
தோழன் என்பதன் பொருள் அற்பன்	தோலன் என்பதன் பொருள் அற்பன்	RWE_M	0
தோலன் என்பதன் பொருள் நண்பன்	தோழன் என்பதன் பொருள் நண்பன்	RWE_M	0
தோழி என்பதன் பொருள் பிசின்	தோலி என்பதன் பொருள் பிசின்	RWE_M	0
தோளி என்பதன் பொருள் பிசின்	தோலி என்பதன் பொருள் பிசின்	RWE_M	0
தோழி என்பதன் பொருள் ஒருவகை மீன்	தோலி என்பதன் பொருள் ஒருவகை மீன்	RWE_M	0
தோளி என்பதன் பொருள் ஒருவகை மீன்	தோலி என்பதன் பொருள் ஒருவகை மீன்	RWE_M	0
தோளி என்பதன் பொருள் பாங்கி	தோழி என்பதன் பொருள் பாங்கி	RWE_M	0
தோலி என்பதன் பொருள் பாங்கி	தோழி என்பதன் பொருள் பாங்கி	RWE_M	0
தோளி என்பதன் பொருள் நட்பால் நெருக்கமானவள்	தோழி என்பதன் பொருள் நட்பால் நெருக்கமானவள்	RWE_M	0
தோலி என்பதன் பொருள் நட்பால் நெருக்கமானவள்	தோழி என்பதன் பொருள் நட்பால் நெருக்கமானவள்	RWE_M	0
தோலி என்பதன் பொருள் அவுரி, ஒருவகை குத்துச்செடி	தோளி என்பதன் பொருள் அவுரி, ஒருவகை குத்துச்செடி	RWE_M	0
தோழி என்பதன் பொருள் அவுரி, ஒருவகை குத்துச்செடி	தோளி என்பதன் பொருள் அவுரி, ஒருவகை குத்துச்செடி	RWE_M	0
தோலி என்பதன் பொருள் அரக்கு	தோளி என்பதன் பொருள் அரக்கு	RWE_M	0
தோழி என்பதன் பொருள் அரக்கு	தோளி என்பதன் பொருள் அரக்கு	RWE_M	0
தோள் என்பதன் பொருள் சருமம்	தோல் என்பதன் பொருள் சருமம்	RWE_M	0
தோள் என்பதன் பொருள் வனப்பு	தோல் என்பதன் பொருள் வனப்பு	RWE_M	0
தோள் என்பதன் பொருள் விதையின் மேல்பகுதி	தோல் என்பதன் பொருள் விதையின் மேல்பகுதி	RWE_M	0
தோல் என்பதன் பொருள் புயம்	தோள் என்பதன் பொருள் புயம்	RWE_M	0
தோல் என்பதன் பொருள் வீரம்	தோள் என்பதன் பொருள் வீரம்	RWE_M	0
நளன் என்பதன் பொருள் நலம்	நலன் என்பதன் பொருள் நலம்	RWE_M	0
நளன் என்பதன் பொருள் அழகு	நலன் என்பதன் பொருள் அழகு	RWE_M	0
நளன் என்பதன் பொருள் புகழ்	நலன் என்பதன் பொருள் புகழ்	RWE_M	0
நளன் என்பதன் பொருள் இன்பம்	நலன் என்பதன் பொருள் இன்பம்	RWE_M	0
நளன் என்பதன் பொருள் நன்மை	நலன் என்பதன் பொருள் நன்மை	RWE_M	0
நளன் என்பதன் பொருள் குணம்	நலன் என்பதன் பொருள் குணம்	RWE_M	0
நலன் என்பதன் பொருள் தமயந்தியின் கணவன்	நளன் என்பதன் பொருள் தமயந்தியின் கணவன்	RWE_M	0
நலன் என்பதன் பொருள் ஓர் அரசன்	நளன் என்பதன் பொருள் ஓர் அரசன்	RWE_M	0
நளி என்பதன் பொருள் நோய்	நலி என்பதன் பொருள் நோய்	RWE_M	0
நலி என்பதன் பொருள் குளிர்ச்சி	நளி என்பதன் பொருள் குளிர்ச்சி	RWE_M	0
நலி என்பதன் பொருள் பெருமை	நளி என்பதன் பொருள் பெருமை	RWE_M	0
நளிதல் என்பதன் பொருள் நலிந்துபோதல்	நலிதல் என்பதன் பொருள் நலிந்துபோதல்	RWE_M	0
நளிதல் என்பதன் பொருள் தோற்றல்	நலிதல் என்பதன் பொருள் தோற்றல்	RWE_M	0
நலிதல் என்பதன் பொருள் செறிதல்	நளிதல் என்பதன் பொருள் செறிதல்	RWE_M	0
நலிதல் என்பதன் பொருள் பரத்தல்	நளிதல் என்பதன் பொருள் பரத்தல்	RWE_M	0
நலிதல் என்பதன் பொருள் ஒத்தல்	நளிதல் என்பதன் பொருள் ஒத்தல்	RWE_M	0
நள் என்பதன் பொருள் நல்ல	நல் என்பதன் பொருள் நல்ல	RWE_M	0
நல் என்பதன் பொருள் இரவு	நள் என்பதன் பொருள் இரவு	RWE_M	0
நல் என்பதன் பொருள் நடு	நள் என்பதன் பொருள் நடு	RWE_M	0
நல் என்பதன் பொருள் நள்ளிரவு	நள் என்பதன் பொருள் நள்ளிரவு	RWE_M	0
நாழம் என்பதன் பொருள் பூவின் காம்பு	நாலம் என்பதன் பொருள் பூவின் காம்பு	RWE_M	0
நாளம் என்பதன் பொருள் பூவின் காம்பு	நாலம் என்பதன் பொருள் பூவின் காம்பு	RWE_M	0
நாளம் என்பதன் பொருள் இழிவுரை	நாழம் என்பதன் பொருள் இழிவுரை	RWE_M	0
நாலம் என்பதன் பொருள் இழிவுரை	நாழம் என்பதன் பொருள் இழிவுரை	RWE_M	0
நாளம் என்பதன் பொருள் வசவு	நாழம் என்பதன் பொருள் வசவு	RWE_M	0
நாலம் என்பதன் பொருள் வசவு	நாழம் என்பதன் பொருள் வசவு	RWE_M	0
நாலம் என்பதன் பொருள் பூந்தண்டு	நாளம் என்பதன் பொருள் பூந்தண்டு	RWE_M	0
நாழம் என்பதன் பொருள் பூந்தண்டு	நாளம் என்பதன் பொருள் பூந்தண்டு	RWE_M	0
நாலம் என்பதன் பொருள் உட்துளை	நாளம் என்பதன் பொருள் உட்துளை	RWE_M	0
நாழம் என்பதன் பொருள் உட்துளை	நாளம் என்பதன் பொருள் உட்துளை	RWE_M	0
நாலம் என்பதன் பொருள் ரத்தநாளம்	நாளம் என்பதன் பொருள் ரத்தநாளம்	RWE_M	0
நாழம் என்பதன் பொருள் ரத்தநாளம்	நாளம் என்பதன் பொருள் ரத்தநாளம்	RWE_M	0
நாளி என்பதன் பொருள் முத்து	நாலி என்பதன் பொருள் முத்து	RWE_M	0
நாழி என்பதன் பொருள் முத்து	நாலி என்பதன் பொருள் முத்து	RWE_M	0
நாளி என்பதன் பொருள் கந்தை ஆடை	நாலி என்பதன் பொருள் கந்தை ஆடை	RWE_M	0
நாழி என்பதன் பொருள் கந்தை ஆடை	நாலி என்பதன் பொருள் கந்தை ஆடை	RWE_M	0
நாழி என்பதன் பொருள் கல்	நாளி என்பதன் பொருள் கல்	RWE_M	0
நாலி என்பதன் பொருள் கல்	நாளி என்பதன் பொருள் கல்	RWE_M	0
நாழி என்பதன் பொருள் நாய்	நாளி என்பதன் பொருள் நாய்	RWE_M	0
நாலி என்பதன் பொருள் நாய்	நாளி என்பதன் பொருள் நாய்	RWE_M	0
நாலி என்பதன் பொருள் உள்தொளையுள்ள பொருள்	நாழி என்பதன் பொருள் உள்தொளையுள்ள பொருள்	RWE_M	0
நாளி என்பதன் பொருள் உள்தொளையுள்ள பொருள்	நாழி என்பதன் பொருள் உள்தொளையுள்ள பொருள்	RWE_M	0
நாலி என்பதன் பொருள் ஒருபடி	நாழி என்பதன் பொருள் ஒருபடி	RWE_M	0
நாளி என்பதன் பொருள் ஒருபடி	நாழி என்பதன் பொருள் ஒருபடி	RWE_M	0
நாலி என்பதன் பொருள் ஏர்	நாழி என்பதன் பொருள் ஏர்	RWE_M	0
நாளி என்பதன் பொருள் ஏர்	நாழி என்பதன் பொருள் ஏர்	RWE_M	0
நாலி என்பதன் பொருள் அம்பறாத்துணி	நாழி என்பதன் பொருள் அம்பறாத்துணி	RWE_M	0
நாளி என்பதன் பொருள் அம்பறாத்துணி	நாழி என்பதன் பொருள் அம்பறாத்துணி	RWE_M	0
நாலி என்பதன் பொருள் நாடா	நாழி என்பதன் பொருள் நாடா	RWE_M	0
நாளி என்பதன் பொருள் நாடா	நாழி என்பதன் பொருள் நாடா	RWE_M	0
நாலி என்பதன் பொருள் பூரட்டாதி	நாழி என்பதன் பொருள் பூரட்டாதி	RWE_M	0
நாளி என்பதன் பொருள் பூரட்டாதி	நாழி என்பதன் பொருள் பூரட்டாதி	RWE_M	0
நாழிகை என்பதன் பொருள் மூங்கில்	நாலிகை என்பதன் பொருள் மூங்கில்	RWE_M	0
நாழிகை என்பதன் பொருள் அடுப்புச்சந்து	நாலிகை என்பதன் பொருள் அடுப்புச்சந்து	RWE_M	0
நாலிகை என்பதன் பொருள் வட்டம்	நாழிகை என்பதன் பொருள் வட்டம்	RWE_M	0
நாலிகை என்பதன் பொருள் கடிகாரம்	நாழிகை என்பதன் பொருள் கடிகாரம்	RWE_M	0
நாழ் என்பதன் பொருள் நான்கு	நால் என்பதன் பொருள் நான்கு	RWE_M	0
நாள் என்பதன் பொருள் நான்கு	நால் என்பதன் பொருள் நான்கு	RWE_M	0
நாள் என்பதன் பொருள் குற்றம்	நாழ் என்பதன் பொருள் குற்றம்	RWE_M	0
நால் என்பதன் பொருள் குற்றம்	நாழ் என்பதன் பொருள் குற்றம்	RWE_M	0
நாள் என்பதன் பொருள் செருக்கு	நாழ் என்பதன் பொருள் செருக்கு	RWE_M	0
நால் என்பதன் பொருள் செருக்கு	நாழ் என்பதன் பொருள் செருக்கு	RWE_M	0
நால் என்பதன் பொருள் காலம்	நாள் என்பதன் பொருள் காலம்	RWE_M	0
நாழ் என்பதன் பொருள் காலம்	நாள் என்பதன் பொருள் காலம்	RWE_M	0
நால் என்பதன் பொருள் திதி	நாள் என்பதன் பொருள் திதி	RWE_M	0
நாழ் என்பதன் பொருள் திதி	நாள் என்பதன் பொருள் திதி	RWE_M	0
நீளம் என்பதன் பொருள் ஒரு நிறம்	நீலம் என்பதன் பொருள் ஒரு நிறம்	RWE_M	0
நீளம் என்பதன் பொருள் கருங்குவளை	நீலம் என்பதன் பொருள் கருங்குவளை	RWE_M	0
நீளம் என்பதன் பொருள் இருள்	நீலம் என்பதன் பொருள் இருள்	RWE_M	0
நீலம் என்பதன் பொருள் நெடுமை 	நீளம் என்பதன் பொருள் நெடுமை 	RWE_M	0
நீலம் என்பதன் பொருள் நீண்ட	நீளம் என்பதன் பொருள் நீண்ட	RWE_M	0
நீலம் என்பதன் பொருள் தாமதம்	நீளம் என்பதன் பொருள் தாமதம்	RWE_M	0
நீள் என்பதன் பொருள் நீலம்	நீல் என்பதன் பொருள் நீலம்	RWE_M	0
நீள் என்பதன் பொருள் காற்று	நீல் என்பதன் பொருள் காற்று	RWE_M	0
நீல் என்பதன் பொருள் நீளம்	நீள் என்பதன் பொருள் நீளம்	RWE_M	0
நீல் என்பதன் பொருள் ஒளி	நீள் என்பதன் பொருள் ஒளி	RWE_M	0
பழம் என்பதன் பொருள் கிழங்கு	பலம் என்பதன் பொருள் கிழங்கு	RWE_M	0
பழம் என்பதன் பொருள் வலி	பலம் என்பதன் பொருள் வலி	RWE_M	0
பழம் என்பதன் பொருள் நெற்றி	பலம் என்பதன் பொருள் நெற்றி	RWE_M	0
பழம் என்பதன் பொருள் சக்தி	பலம் என்பதன் பொருள் சக்தி	RWE_M	0
பழம் என்பதன் பொருள் சேனை	பலம் என்பதன் பொருள் சேனை	RWE_M	0
பழம் என்பதன் பொருள் வன்மை	பலம் என்பதன் பொருள் வன்மை	RWE_M	0
பழம் என்பதன் பொருள் உறுதி	பலம் என்பதன் பொருள் உறுதி	RWE_M	0
பழம் என்பதன் பொருள் எடை	பலம் என்பதன் பொருள் எடை	RWE_M	0
பலம் என்பதன் பொருள் கனி	பழம் என்பதன் பொருள் கனி	RWE_M	0
பலம் என்பதன் பொருள் முதுமை	பழம் என்பதன் பொருள் முதுமை	RWE_M	0
பள்ளி என்பதன் பொருள் சிற்றூர்	பல்லி என்பதன் பொருள் சிற்றூர்	RWE_M	0
பள்ளி என்பதன் பொருள் இடையர் ஊர்	பல்லி என்பதன் பொருள் இடையர் ஊர்	RWE_M	0
பள்ளி என்பதன் பொருள் உழுகருவி	பல்லி என்பதன் பொருள் உழுகருவி	RWE_M	0
பள்ளி என்பதன் பொருள் ஓர் உயிரி	பல்லி என்பதன் பொருள் ஓர் உயிரி	RWE_M	0
பள்ளி என்பதன் பொருள் வண்டியுறுப்பு	பல்லி என்பதன் பொருள் வண்டியுறுப்பு	RWE_M	0
பல்லி என்பதன் பொருள் இடைச்சேரி	பள்ளி என்பதன் பொருள் இடைச்சேரி	RWE_M	0
பல்லி என்பதன் பொருள் புத்தர் கோயில்	பள்ளி என்பதன் பொருள் புத்தர் கோயில்	RWE_M	0
பல்லி என்பதன் பொருள் குறும்பன்	பள்ளி என்பதன் பொருள் குறும்பன்	RWE_M	0
பல்லி என்பதன் பொருள் மருதநிலத்தூர்	பள்ளி என்பதன் பொருள் மருதநிலத்தூர்	RWE_M	0
பல்லி என்பதன் பொருள் படுக்கை	பள்ளி என்பதன் பொருள் படுக்கை	RWE_M	0
பல்லி என்பதன் பொருள் பள்ளிக்கூடம்	பள்ளி என்பதன் பொருள் பள்ளிக்கூடம்	RWE_M	0
பழி என்பதன் பொருள் பலியிடுதல்	பலி என்பதன் பொருள் பலியிடுதல்	RWE_M	0
பழி என்பதன் பொருள் பலியுயிர்	பலி என்பதன் பொருள் பலியுயிர்	RWE_M	0
பலி என்பதன் பொருள் குற்றம்	பழி என்பதன் பொருள் குற்றம்	RWE_M	0
பாழ் என்பதன் பொருள் திரவ உணவு	பால் என்பதன் பொருள் திரவ உணவு	RWE_M	0
பாழ் என்பதன் பொருள் பகுப்பு	பால் என்பதன் பொருள் பகுப்பு	RWE_M	0
பாழ் என்பதன் பொருள் இயல்பு	பால் என்பதன் பொருள் இயல்பு	RWE_M	0
பால் என்பதன் பொருள் வீண்	பாழ் என்பதன் பொருள் வீண்	RWE_M	0
பால் என்பதன் பொருள் வெறுமை	பாழ் என்பதன் பொருள் வெறுமை	RWE_M	0
பீளை என்பதன் பொருள் துன்பம்	பீழை என்பதன் பொருள் துன்பம்	RWE_M	0
பீழை என்பதன் பொருள் கண் அழுக்கு	பீளை என்பதன் பொருள் கண் அழுக்கு	RWE_M	0
புளி என்பதன் பொருள் காட்டு விலங்கு	புலி என்பதன் பொருள் காட்டு விலங்கு	RWE_M	0
புலி என்பதன் பொருள் புளியமரம்	புளி என்பதன் பொருள் புளியமரம்	RWE_M	0
புலி என்பதன் பொருள் புளியங்காய்	புளி என்பதன் பொருள் புளியங்காய்	RWE_M	0
புழை என்பதன் பொருள் புலால்	புலை என்பதன் பொருள் புலால்	RWE_M	0
புழை என்பதன் பொருள் ஊன்	புலை என்பதன் பொருள் ஊன்	RWE_M	0
புழை என்பதன் பொருள் கீழ்மை	புலை என்பதன் பொருள் கீழ்மை	RWE_M	0
புலை என்பதன் பொருள் துளை	புழை என்பதன் பொருள் துளை	RWE_M	0
புலை என்பதன் பொருள் வாயில்	புழை என்பதன் பொருள் வாயில்	RWE_M	0
புலை என்பதன் பொருள் நரகம்	புழை என்பதன் பொருள் நரகம்	RWE_M	0
புகழ் என்பதன் பொருள் அடைக்கலம்	புகல் என்பதன் பொருள் அடைக்கலம்	RWE_M	0
புகல் என்பதன் பொருள் பெருமை	புகழ் என்பதன் பொருள் பெருமை	RWE_M	0
புள் என்பதன் பொருள் அற்பம்	புல் என்பதன் பொருள் அற்பம்	RWE_M	0
புள் என்பதன் பொருள் கலவி	புல் என்பதன் பொருள் கலவி	RWE_M	0
புள் என்பதன் பொருள் புல்பூண்டு	புல் என்பதன் பொருள் புல்பூண்டு	RWE_M	0
புல் என்பதன் பொருள் பறவை	புள் என்பதன் பொருள் பறவை	RWE_M	0
பூளம் என்பதன் பொருள் புற்கட்டு	பூலம் என்பதன் பொருள் புற்கட்டு	RWE_M	0
பூலம் என்பதன் பொருள் பூவரசு	பூளம் என்பதன் பொருள் பூவரசு	RWE_M	0
பூளை என்பதன் பொருள் துவாரம்	பூழை என்பதன் பொருள் துவாரம்	RWE_M	0
பூளை என்பதன் பொருள் கோபுரவாயில்	பூழை என்பதன் பொருள் கோபுரவாயில்	RWE_M	0
பூழை என்பதன் பொருள் பூளைச்செடி	பூளை என்பதன் பொருள் பூளைச்செடி	RWE_M	0
பூழை என்பதன் பொருள் இலவம் பஞ்சு	பூளை என்பதன் பொருள் இலவம் பஞ்சு	RWE_M	0
பாழி என்பதன் பொருள் தானியக் குவியல்	பாலி என்பதன் பொருள் தானியக் குவியல்	RWE_M	0
பாளி என்பதன் பொருள் தானியக் குவியல்	பாலி என்பதன் பொருள் தானியக் குவியல்	RWE_M	0
பாழி என்பதன் பொருள் தூற்றாத தானியம்	பாலி என்பதன் பொருள் தூற்றாத தானியம்	RWE_M	0
பாளி என்பதன் பொருள் தூற்றாத தானியம்	பாலி என்பதன் பொருள் தூற்றாத தானியம்	RWE_M	0
பாளி என்பதன் பொருள் கொடுத்தல்	பாழி என்பதன் பொருள் கொடுத்தல்	RWE_M	0
பாலி என்பதன் பொருள் கொடுத்தல்	பாழி என்பதன் பொருள் கொடுத்தல்	RWE_M	0
பாளி என்பதன் பொருள் ஈதல்	பாழி என்பதன் பொருள் ஈதல்	RWE_M	0
பாலி என்பதன் பொருள் ஈதல்	பாழி என்பதன் பொருள் ஈதல்	RWE_M	0
பாழி என்பதன் பொருள் வரப்பு	பாளி என்பதன் பொருள் வரப்பு	RWE_M	0
பாலி என்பதன் பொருள் வரப்பு	பாளி என்பதன் பொருள் வரப்பு	RWE_M	0
பாழி என்பதன் பொருள் எல்லை	பாளி என்பதன் பொருள் எல்லை	RWE_M	0
பாலி என்பதன் பொருள் எல்லை	பாளி என்பதன் பொருள் எல்லை	RWE_M	0
பாழிவு என்பதன் பொருள் அழகு	பாலிவு என்பதன் பொருள் அழகு	RWE_M	0
பாழிவு என்பதன் பொருள் நிறைவு	பாலிவு என்பதன் பொருள் நிறைவு	RWE_M	0
பாலிவு என்பதன் பொருள் பொழிதல்	பாழிவு என்பதன் பொருள் பொழிதல்	RWE_M	0
பாலிவு என்பதன் பொருள் மேன்மை	பாழிவு என்பதன் பொருள் மேன்மை	RWE_M	0
போளி என்பதன் பொருள் பொய்	போலி என்பதன் பொருள் பொய்	RWE_M	0
போளி என்பதன் பொருள் வஞ்சகம்	போலி என்பதன் பொருள் வஞ்சகம்	RWE_M	0
போளி என்பதன் பொருள் ஒப்பு	போலி என்பதன் பொருள் ஒப்பு	RWE_M	0
போலி என்பதன் பொருள் இனிப்புப் பண்டம்	போளி என்பதன் பொருள் இனிப்புப் பண்டம்	RWE_M	0
பொழிதல் என்பதன் பொருள் செழித்தல்	பொலிதல் என்பதன் பொருள் செழித்தல்	RWE_M	0
பொழிதல் என்பதன் பொருள் மங்கலமாதல்	பொலிதல் என்பதன் பொருள் மங்கலமாதல்	RWE_M	0
பொலிதல் என்பதன் பொருள் ஈதல்	பொழிதல் என்பதன் பொருள் ஈதல்	RWE_M	0
பொலிதல் என்பதன் பொருள் கொடுத்தல்	பொழிதல் என்பதன் பொருள் கொடுத்தல்	RWE_M	0
பொலிதல் என்பதன் பொருள் சொரிதல்	பொழிதல் என்பதன் பொருள் சொரிதல்	RWE_M	0
பொலிதல் என்பதன் பொருள் பெய்தல்	பொழிதல் என்பதன் பொருள் பெய்தல்	RWE_M	0
பொலிதல் என்பதன் பொருள் நிறைதல்	பொழிதல் என்பதன் பொருள் நிறைதல்	RWE_M	0
மழம் என்பதன் பொருள் அழுக்கு	மலம் என்பதன் பொருள் அழுக்கு	RWE_M	0
மழம் என்பதன் பொருள் பாவம்	மலம் என்பதன் பொருள் பாவம்	RWE_M	0
மலம் என்பதன் பொருள் இளமை	மழம் என்பதன் பொருள் இளமை	RWE_M	0
மலம் என்பதன் பொருள் குழந்தை	மழம் என்பதன் பொருள் குழந்தை	RWE_M	0
மழை என்பதன் பொருள் குன்று	மலை என்பதன் பொருள் குன்று	RWE_M	0
மழை என்பதன் பொருள் பொருப்பு	மலை என்பதன் பொருள் பொருப்பு	RWE_M	0
மழை என்பதன் பொருள் வெற்பு	மலை என்பதன் பொருள் வெற்பு	RWE_M	0
மழை என்பதன் பொருள் சிகரம்	மலை என்பதன் பொருள் சிகரம்	RWE_M	0
மலை என்பதன் பொருள் மழைநீர்	மழை என்பதன் பொருள் மழைநீர்	RWE_M	0
மலை என்பதன் பொருள் குளிர்ச்சி	மழை என்பதன் பொருள் குளிர்ச்சி	RWE_M	0
மலை என்பதன் பொருள் மேகம்	மழை என்பதன் பொருள் மேகம்	RWE_M	0
மழைத்தல் என்பதன் பொருள் வியத்தல்	மலைத்தல் என்பதன் பொருள் வியத்தல்	RWE_M	0
மழைத்தல் என்பதன் பொருள் தடுமாறுதல்	மலைத்தல் என்பதன் பொருள் தடுமாறுதல்	RWE_M	0
மலைத்தல் என்பதன் பொருள் மழை பெய்திருத்தல்	மழைத்தல் என்பதன் பொருள் மழை பெய்திருத்தல்	RWE_M	0
மலைத்தல் என்பதன் பொருள் குளிர்ந்திருத்தல்	மழைத்தல் என்பதன் பொருள் குளிர்ந்திருத்தல்	RWE_M	0
மாளை என்பதன் பொருள் அந்திப்பொழுது	மாலை என்பதன் பொருள் அந்திப்பொழுது	RWE_M	0
மாழை என்பதன் பொருள் பூமாலை	மாலை என்பதன் பொருள் பூமாலை	RWE_M	0
மாளை என்பதன் பொருள் மயக்கம்	மாழை என்பதன் பொருள் மயக்கம்	RWE_M	0
மாலை என்பதன் பொருள் மயக்கம்	மாழை என்பதன் பொருள் மயக்கம்	RWE_M	0
மாளை என்பதன் பொருள் இளமை	மாழை என்பதன் பொருள் இளமை	RWE_M	0
மாலை என்பதன் பொருள் இளமை	மாழை என்பதன் பொருள் இளமை	RWE_M	0
மாளை என்பதன் பொருள் அழகு	மாழை என்பதன் பொருள் அழகு	RWE_M	0
மாலை என்பதன் பொருள் அழகு	மாழை என்பதன் பொருள் அழகு	RWE_M	0
மாழை என்பதன் பொருள் புளியம்பட்டை	மாளை என்பதன் பொருள் புளியம்பட்டை	RWE_M	0
மாலை என்பதன் பொருள் புளியம்பட்டை	மாளை என்பதன் பொருள் புளியம்பட்டை	RWE_M	0
மாள் என்பதன் பொருள் திருமால்	மால் என்பதன் பொருள் திருமால்	RWE_M	0
மாள் என்பதன் பொருள் மயக்கம்	மால் என்பதன் பொருள் மயக்கம்	RWE_M	0
மாள் என்பதன் பொருள் அருகன்	மால் என்பதன் பொருள் அருகன்	RWE_M	0
மாள் என்பதன் பொருள் இந்திரன்	மால் என்பதன் பொருள் இந்திரன்	RWE_M	0
மாள் என்பதன் பொருள் பெருமை	மால் என்பதன் பொருள் பெருமை	RWE_M	0
மாள் என்பதன் பொருள் மேகம்	மால் என்பதன் பொருள் மேகம்	RWE_M	0
மால் என்பதன் பொருள் இறத்தல்	மாள் என்பதன் பொருள் இறத்தல்	RWE_M	0
மால் என்பதன் பொருள் சாதல் 	மாள் என்பதன் பொருள் சாதல் 	RWE_M	0
முழை என்பதன் பொருள் உடலிலுள்ள ஓர் உறுப்பு	முலை என்பதன் பொருள் உடலிலுள்ள ஓர் உறுப்பு	RWE_M	0
முளை என்பதன் பொருள் உடலிலுள்ள ஓர் உறுப்பு	முலை என்பதன் பொருள் உடலிலுள்ள ஓர் உறுப்பு	RWE_M	0
முளை என்பதன் பொருள் குகை	முழை என்பதன் பொருள் குகை	RWE_M	0
முலை என்பதன் பொருள் குகை	முழை என்பதன் பொருள் குகை	RWE_M	0
முலை என்பதன் பொருள் முளைத்தல்	முளை என்பதன் பொருள் முளைத்தல்	RWE_M	0
முழை என்பதன் பொருள் முளைத்தல்	முளை என்பதன் பொருள் முளைத்தல்	RWE_M	0
முலை என்பதன் பொருள் தறி	முளை என்பதன் பொருள் தறி	RWE_M	0
முழை என்பதன் பொருள் தறி	முளை என்பதன் பொருள் தறி	RWE_M	0
முலை என்பதன் பொருள் ஆப்பு	முளை என்பதன் பொருள் ஆப்பு	RWE_M	0
முழை என்பதன் பொருள் ஆப்பு	முளை என்பதன் பொருள் ஆப்பு	RWE_M	0
முலை என்பதன் பொருள் அங்குசம் 	முளை என்பதன் பொருள் அங்குசம் 	RWE_M	0
முழை என்பதன் பொருள் அங்குசம் 	முளை என்பதன் பொருள் அங்குசம் 	RWE_M	0
முலை என்பதன் பொருள் இளமை	முளை என்பதன் பொருள் இளமை	RWE_M	0
முழை என்பதன் பொருள் இளமை	முளை என்பதன் பொருள் இளமை	RWE_M	0
முலை என்பதன் பொருள் தண்டு	முளை என்பதன் பொருள் தண்டு	RWE_M	0
முழை என்பதன் பொருள் தண்டு	முளை என்பதன் பொருள் தண்டு	RWE_M	0
முலை என்பதன் பொருள் மூங்கில்	முளை என்பதன் பொருள் மூங்கில்	RWE_M	0
முழை என்பதன் பொருள் மூங்கில்	முளை என்பதன் பொருள் மூங்கில்	RWE_M	0
முளி என்பதன் பொருள் விழித்தல்	முழி என்பதன் பொருள் விழித்தல்	RWE_M	0
முழி என்பதன் பொருள் மரக்கணு	முளி என்பதன் பொருள் மரக்கணு	RWE_M	0
முழி என்பதன் பொருள் விரல்முளி	முளி என்பதன் பொருள் விரல்முளி	RWE_M	0
முழி என்பதன் பொருள் வாட்டம்	முளி என்பதன் பொருள் வாட்டம்	RWE_M	0
மூழி என்பதன் பொருள் மூலிகை	மூலி என்பதன் பொருள் மூலிகை	RWE_M	0
மூழி என்பதன் பொருள் மரம்	மூலி என்பதன் பொருள் மரம்	RWE_M	0
மூலி என்பதன் பொருள் வேருள்ளது	மூலி என்பதன் பொருள் வேருள்ளது	RWE_M	0
மூலி என்பதன் பொருள் அகப்பை	மூழி என்பதன் பொருள் அகப்பை	RWE_M	0
மூலி என்பதன் பொருள் சோறு	மூழி என்பதன் பொருள் சோறு	RWE_M	0
மூலி என்பதன் பொருள் நீர்நிலை	மூழி என்பதன் பொருள் நீர்நிலை	RWE_M	0
மூலி என்பதன் பொருள் கோணம்	மூழி என்பதன் பொருள் கோணம்	RWE_M	0
மூளை என்பதன் பொருள் இரு கோடுகள் சந்திக்கும் இடம்	மூலை என்பதன் பொருள் இரு கோடுகள் சந்திக்கும் இடம்	RWE_M	0
மூலை என்பதன் பொருள் மண்டைக்குள் இருக்கும் ஓர் உறுப்பு	மூளை என்பதன் பொருள் மண்டைக்குள் இருக்கும் ஓர் உறுப்பு	RWE_M	0
மெள்ள என்பதன் பொருள் மென்று தின்பது	மெல்ல என்பதன் பொருள் மென்று தின்பது	RWE_M	0
மெல்ல என்பதன் பொருள் மெதுவாக	மெள்ள என்பதன் பொருள் மெதுவாக	RWE_M	0
மாழி என்பதன் பொருள் மொளலி கிரீடம்	மாலி என்பதன் பொருள் மொளலி கிரீடம்	RWE_M	0
மாளி என்பதன் பொருள் மொளலி கிரீடம்	மாலி என்பதன் பொருள் மொளலி கிரீடம்	RWE_M	0
மாளி என்பதன் பொருள் மேழி	மாழி என்பதன் பொருள் மேழி	RWE_M	0
மாலி என்பதன் பொருள் மேழி	மாழி என்பதன் பொருள் மேழி	RWE_M	0
மாளி என்பதன் பொருள் கலப்பை	மாழி என்பதன் பொருள் கலப்பை	RWE_M	0
மாலி என்பதன் பொருள் கலப்பை	மாழி என்பதன் பொருள் கலப்பை	RWE_M	0
மாலி என்பதன் பொருள் துணிமூட்டை	மாளி என்பதன் பொருள் துணிமூட்டை	RWE_M	0
மாழி என்பதன் பொருள் துணிமூட்டை	மாளி என்பதன் பொருள் துணிமூட்டை	RWE_M	0
வளம் என்பதன் பொருள் சுற்றுதல்	வலம் என்பதன் பொருள் சுற்றுதல்	RWE_M	0
வளம் என்பதன் பொருள் வலப்பக்கம்	வலம் என்பதன் பொருள் வலப்பக்கம்	RWE_M	0
வளம் என்பதன் பொருள் வெற்றி	வலம் என்பதன் பொருள் வெற்றி	RWE_M	0
வலம் என்பதன் பொருள் வளமை	வளம் என்பதன் பொருள் வளமை	RWE_M	0
வலம் என்பதன் பொருள் அழகு	வளம் என்பதன் பொருள் அழகு	RWE_M	0
வளவன் என்பதன் பொருள் திருமால்	வலவன் என்பதன் பொருள் திருமால்	RWE_M	0
வலவன் என்பதன் பொருள் சோழன்	வளவன் என்பதன் பொருள் சோழன்	RWE_M	0
வலவன் என்பதன் பொருள் வேளாளன்	வளவன் என்பதன் பொருள் வேளாளன்	RWE_M	0
வளன் ஓர் அரசன்	வலன் ஓர் அரசன்	RWE_M	0
வளன் என்பதன் பொருள் வெற்றி	வலன் என்பதன் பொருள் வெற்றி	RWE_M	0
வளன் என்பதன் பொருள் வல்லவன்	வலன் என்பதன் பொருள் வல்லவன்	RWE_M	0
வலன் என்பதன் பொருள் செழுமை	வளன் என்பதன் பொருள் செழுமை	RWE_M	0
வலன் என்பதன் பொருள் வளப்பன்	வளன் என்பதன் பொருள் வளப்பன்	RWE_M	0
வளப்பம் என்பதன் பொருள் வழக்கம்	வழப்பம் என்பதன் பொருள் வழக்கம்	RWE_M	0
வளப்பம் என்பதன் பொருள் இயல்பு	வழப்பம் என்பதன் பொருள் இயல்பு	RWE_M	0
வழப்பம் என்பதன் பொருள் வளமை	வளப்பம் என்பதன் பொருள் வளமை	RWE_M	0
வழப்பம் என்பதன் பொருள் செழிப்பு	வளப்பம் என்பதன் பொருள் செழிப்பு	RWE_M	0
வளி என்பதன் பொருள் நோய்	வலி என்பதன் பொருள் நோய்	RWE_M	0
வழி என்பதன் பொருள் நோய்	வலி என்பதன் பொருள் நோய்	RWE_M	0
வளி என்பதன் பொருள் வலிமை	வலி என்பதன் பொருள் வலிமை	RWE_M	0
வழி என்பதன் பொருள் வலிமை	வலி என்பதன் பொருள் வலிமை	RWE_M	0
வளி என்பதன் பொருள் துன்பம்	வலி என்பதன் பொருள் துன்பம்	RWE_M	0
வழி என்பதன் பொருள் துன்பம்	வலி என்பதன் பொருள் துன்பம்	RWE_M	0
வலி என்பதன் பொருள் நெறி	வழி என்பதன் பொருள் நெறி	RWE_M	0
வளி என்பதன் பொருள் நெறி	வழி என்பதன் பொருள் நெறி	RWE_M	0
வலி என்பதன் பொருள் பாதை	வழி என்பதன் பொருள் பாதை	RWE_M	0
வளி என்பதன் பொருள் பாதை	வழி என்பதன் பொருள் பாதை	RWE_M	0
வலி என்பதன் பொருள் தடம்	வழி என்பதன் பொருள் தடம்	RWE_M	0
வளி என்பதன் பொருள் தடம்	வழி என்பதன் பொருள் தடம்	RWE_M	0
வலி என்பதன் பொருள் உபாயம்	வழி என்பதன் பொருள் உபாயம்	RWE_M	0
வளி என்பதன் பொருள் உபாயம்	வழி என்பதன் பொருள் உபாயம்	RWE_M	0
வலி என்பதன் பொருள் காற்று	வளி என்பதன் பொருள் காற்று	RWE_M	0
வழி என்பதன் பொருள் காற்று	வளி என்பதன் பொருள் காற்று	RWE_M	0
வழை என்பதன் பொருள் மீன் முதலியன பிடிக்கும் ஒரு கருவி	வலை என்பதன் பொருள் மீன் முதலியன பிடிக்கும் ஒரு கருவி	RWE_M	0
வளை என்பதன் பொருள் மீன் முதலியன பிடிக்கும் ஒரு கருவி	வலை என்பதன் பொருள் மீன் முதலியன பிடிக்கும் ஒரு கருவி	RWE_M	0
வளை என்பதன் பொருள் சுரபுன்னை	வழை என்பதன் பொருள் சுரபுன்னை	RWE_M	0
வலை என்பதன் பொருள் சுரபுன்னை	வழை என்பதன் பொருள் சுரபுன்னை	RWE_M	0
வளை என்பதன் பொருள் புதுமை	வழை என்பதன் பொருள் புதுமை	RWE_M	0
வலை என்பதன் பொருள் புதுமை	வழை என்பதன் பொருள் புதுமை	RWE_M	0
வளை என்பதன் பொருள் இளமை	வழை என்பதன் பொருள் இளமை	RWE_M	0
வலை என்பதன் பொருள் இளமை	வழை என்பதன் பொருள் இளமை	RWE_M	0
வலை என்பதன் பொருள் கை வளையல்	வளை என்பதன் பொருள் கை வளையல்	RWE_M	0
வழை என்பதன் பொருள் கை வளையல்	வளை என்பதன் பொருள் கை வளையல்	RWE_M	0
வலை என்பதன் பொருள் எலி வளை	வளை என்பதன் பொருள் எலி வளை	RWE_M	0
வழை என்பதன் பொருள் எலி வளை	வளை என்பதன் பொருள் எலி வளை	RWE_M	0
வள் என்பதன் பொருள் வலிமை	வல் என்பதன் பொருள் வலிமை	RWE_M	0
வள் என்பதன் பொருள் விரைவு	வல் என்பதன் பொருள் விரைவு	RWE_M	0
வள் என்பதன் பொருள் திறமை	வல் என்பதன் பொருள் திறமை	RWE_M	0
வல் ஒரு ஒலிக்குறிப்புச் சொல்	வள் ஒரு ஒலிக்குறிப்புச் சொல்	RWE_M	0
வள்ளம் என்பதன் பொருள் வாழை	வல்லம் என்பதன் பொருள் வாழை	RWE_M	0
வள்ளம் ஓர் ஊர்	வல்லம் ஓர் ஊர்	RWE_M	0
வல்லம் என்பதன் பொருள் மரக்கலம்	வள்ளம் என்பதன் பொருள் மரக்கலம்	RWE_M	0
வல்லம் என்பதன் பொருள் படகு	வள்ளம் என்பதன் பொருள் படகு	RWE_M	0
வல்லம் என்பதன் பொருள் அளவு	வள்ளம் என்பதன் பொருள் அளவு	RWE_M	0
வல்லம் என்பதன் பொருள் தொன்னை	வள்ளம் என்பதன் பொருள் தொன்னை	RWE_M	0
வள்ளி என்பதன் பொருள் பூமி	வல்லி என்பதன் பொருள் பூமி	RWE_M	0
வள்ளி என்பதன் பொருள் பெண்	வல்லி என்பதன் பொருள் பெண்	RWE_M	0
வள்ளி என்பதன் பொருள் பிரிதல்	வல்லி என்பதன் பொருள் பிரிதல்	RWE_M	0
வள்ளி என்பதன் பொருள் படர் கொடி	வல்லி என்பதன் பொருள் படர் கொடி	RWE_M	0
வல்லி என்பதன் பொருள் வள்ளியம்மை	வள்ளி என்பதன் பொருள் வள்ளியம்மை	RWE_M	0
வல்லி என்பதன் பொருள் ஆபரணம்	வள்ளி என்பதன் பொருள் ஆபரணம்	RWE_M	0
வல்லி என்பதன் பொருள் சந்திரன்	வள்ளி என்பதன் பொருள் சந்திரன்	RWE_M	0
வழு என்பதன் பொருள் வலிமை	வலு என்பதன் பொருள் வலிமை	RWE_M	0
வளு என்பதன் பொருள் வலிமை	வலு என்பதன் பொருள் வலிமை	RWE_M	0
வழு என்பதன் பொருள் பலம்	வலு என்பதன் பொருள் பலம்	RWE_M	0
வளு என்பதன் பொருள் பலம்	வலு என்பதன் பொருள் பலம்	RWE_M	0
வழு என்பதன் பொருள் பற்று	வலு என்பதன் பொருள் பற்று	RWE_M	0
வளு என்பதன் பொருள் பற்று	வலு என்பதன் பொருள் பற்று	RWE_M	0
வலு என்பதன் பொருள் குற்றம்	வழு என்பதன் பொருள் குற்றம்	RWE_M	0
வளு என்பதன் பொருள் குற்றம்	வழு என்பதன் பொருள் குற்றம்	RWE_M	0
வலு என்பதன் பொருள் தவறு	வழு என்பதன் பொருள் தவறு	RWE_M	0
வளு என்பதன் பொருள் தவறு	வழு என்பதன் பொருள் தவறு	RWE_M	0
வலு என்பதன் பொருள் பழிப்புரை	வழு என்பதன் பொருள் பழிப்புரை	RWE_M	0
வளு என்பதன் பொருள் பழிப்புரை	வழு என்பதன் பொருள் பழிப்புரை	RWE_M	0
வலு என்பதன் பொருள் கேடு	வழு என்பதன் பொருள் கேடு	RWE_M	0
வளு என்பதன் பொருள் கேடு	வழு என்பதன் பொருள் கேடு	RWE_M	0
வழு என்பதன் பொருள் இளமை	வளு என்பதன் பொருள் இளமை	RWE_M	0
வலு என்பதன் பொருள் இளமை	வளு என்பதன் பொருள் இளமை	RWE_M	0
வழு என்பதன் பொருள் இளைய	வளு என்பதன் பொருள் இளைய	RWE_M	0
வலு என்பதன் பொருள் இளைய	வளு என்பதன் பொருள் இளைய	RWE_M	0
வாளி என்பதன் பொருள் கிஷ்கிந்தை அரசன் 	வாலி என்பதன் பொருள் கிஷ்கிந்தை அரசன் 	RWE_M	0
வாழி என்பதன் பொருள் கிஷ்கிந்தை அரசன் 	வாலி என்பதன் பொருள் கிஷ்கிந்தை அரசன் 	RWE_M	0
வாளி என்பதன் பொருள் வாழ்க 	வாழி என்பதன் பொருள் வாழ்க 	RWE_M	0
வாலி என்பதன் பொருள் வாழ்க 	வாழி என்பதன் பொருள் வாழ்க 	RWE_M	0
வாலி என்பதன் பொருள் அன்பு	வாளி என்பதன் பொருள் அன்பு	RWE_M	0
வாழி என்பதன் பொருள் அன்பு	வாளி என்பதன் பொருள் அன்பு	RWE_M	0
வாலி என்பதன் பொருள் வட்ட வாள்	வாளி என்பதன் பொருள் வட்ட வாள்	RWE_M	0
வாழி என்பதன் பொருள் வட்ட வாள்	வாளி என்பதன் பொருள் வட்ட வாள்	RWE_M	0
வாலி என்பதன் பொருள் வீரன்	வாளி என்பதன் பொருள் வீரன்	RWE_M	0
வாழி என்பதன் பொருள் வீரன்	வாளி என்பதன் பொருள் வீரன்	RWE_M	0
வாலி என்பதன் பொருள் ஒரு காதணி	வாளி என்பதன் பொருள் ஒரு காதணி	RWE_M	0
வாழி என்பதன் பொருள் ஒரு காதணி	வாளி என்பதன் பொருள் ஒரு காதணி	RWE_M	0
வாழை என்பதன் பொருள் இளம்பெண்	வாலை என்பதன் பொருள் இளம்பெண்	RWE_M	0
வாளை என்பதன் பொருள் இளம்பெண்	வாலை என்பதன் பொருள் இளம்பெண்	RWE_M	0
வாழை என்பதன் பொருள் திராவகம் வடிக்கும் பாத்திரம்	வாலை என்பதன் பொருள் திராவகம் வடிக்கும் பாத்திரம்	RWE_M	0
வாளை என்பதன் பொருள் திராவகம் வடிக்கும் பாத்திரம்	வாலை என்பதன் பொருள் திராவகம் வடிக்கும் பாத்திரம்	RWE_M	0
வாழை என்பதன் பொருள் ஒரு சக்தி	வாலை என்பதன் பொருள் ஒரு சக்தி	RWE_M	0
வாளை என்பதன் பொருள் ஒரு சக்தி	வாலை என்பதன் பொருள் ஒரு சக்தி	RWE_M	0
வாளை என்பதன் பொருள் வாழைமரம்	வாழை என்பதன் பொருள் வாழைமரம்	RWE_M	0
வாலை என்பதன் பொருள் வாழைமரம்	வாழை என்பதன் பொருள் வாழைமரம்	RWE_M	0
வாலை என்பதன் பொருள் வாளை மீன்	வாளை என்பதன் பொருள் வாளை மீன்	RWE_M	0
வாழை என்பதன் பொருள் வாளை மீன்	வாளை என்பதன் பொருள் வாளை மீன்	RWE_M	0
வாழ் என்பதன் பொருள் விலங்குகளின் ஓர் உறுப்பு	வால் என்பதன் பொருள் விலங்குகளின் ஓர் உறுப்பு	RWE_M	0
வாள் என்பதன் பொருள் விலங்குகளின் ஓர் உறுப்பு	வால் என்பதன் பொருள் விலங்குகளின் ஓர் உறுப்பு	RWE_M	0
வால் என்பதன் பொருள் வாழ்வாயாக	வாழ் என்பதன் பொருள் வாழ்வாயாக	RWE_M	0
வாள் என்பதன் பொருள் வாழ்வாயாக	வாழ் என்பதன் பொருள் வாழ்வாயாக	RWE_M	0
வால் என்பதன் பொருள் போர்வாள்	வாள் என்பதன் பொருள் போர்வாள்	RWE_M	0
வாழ் என்பதன் பொருள் போர்வாள்	வாள் என்பதன் பொருள் போர்வாள்	RWE_M	0
வால் என்பதன் பொருள் நீண்டகத்தி	வாள் என்பதன் பொருள் நீண்டகத்தி	RWE_M	0
வாழ் என்பதன் பொருள் நீண்டகத்தி	வாள் என்பதன் பொருள் நீண்டகத்தி	RWE_M	0
விழா என்பதன் பொருள் விலா எலும்பு	விலா என்பதன் பொருள் விலா எலும்பு	RWE_M	0
விளா என்பதன் பொருள் விலா எலும்பு	விலா என்பதன் பொருள் விலா எலும்பு	RWE_M	0
விளா என்பதன் பொருள் திருவிழா	விழா என்பதன் பொருள் திருவிழா	RWE_M	0
விலா என்பதன் பொருள் திருவிழா	விழா என்பதன் பொருள் திருவிழா	RWE_M	0
விளா என்பதன் பொருள் கொண்டாட்டம்	விழா என்பதன் பொருள் கொண்டாட்டம்	RWE_M	0
விலா என்பதன் பொருள் கொண்டாட்டம்	விழா என்பதன் பொருள் கொண்டாட்டம்	RWE_M	0
விலா என்பதன் பொருள் இளமை	விளா என்பதன் பொருள் இளமை	RWE_M	0
விழா என்பதன் பொருள் இளமை	விளா என்பதன் பொருள் இளமை	RWE_M	0
விலா என்பதன் பொருள் வெண்மை	விளா என்பதன் பொருள் வெண்மை	RWE_M	0
விழா என்பதன் பொருள் வெண்மை	விளா என்பதன் பொருள் வெண்மை	RWE_M	0
விலா என்பதன் பொருள் நிணம்	விளா என்பதன் பொருள் நிணம்	RWE_M	0
விழா என்பதன் பொருள் நிணம்	விளா என்பதன் பொருள் நிணம்	RWE_M	0
விளி என்பதன் பொருள் கண்	விழி என்பதன் பொருள் கண்	RWE_M	0
விளி என்பதன் பொருள் கருவிழி	விழி என்பதன் பொருள் கருவிழி	RWE_M	0
விழி என்பதன் பொருள் கூப்பிடு	விளி என்பதன் பொருள் கூப்பிடு	RWE_M	0
விழி என்பதன் பொருள் அழை	விளி என்பதன் பொருள் அழை	RWE_M	0
விழி என்பதன் பொருள் ஏழிசையில் ஒன்று	விளி என்பதன் பொருள் ஏழிசையில் ஒன்று	RWE_M	0
விழை என்பதன் பொருள் மதிப்பு	விலை என்பதன் பொருள் மதிப்பு	RWE_M	0
விளை என்பதன் பொருள் மதிப்பு	விலை என்பதன் பொருள் மதிப்பு	RWE_M	0
விழை என்பதன் பொருள் விலைக்கு விற்றல்	விலை என்பதன் பொருள் விலைக்கு விற்றல்	RWE_M	0
விளை என்பதன் பொருள் விலைக்கு விற்றல்	விலை என்பதன் பொருள் விலைக்கு விற்றல்	RWE_M	0
விளை என்பதன் பொருள் விரும்பு	விழை என்பதன் பொருள் விரும்பு	RWE_M	0
விலை என்பதன் பொருள் விரும்பு	விழை என்பதன் பொருள் விரும்பு	RWE_M	0
விளை என்பதன் பொருள் ஆசைப்படு	விழை என்பதன் பொருள் ஆசைப்படு	RWE_M	0
விலை என்பதன் பொருள் ஆசைப்படு	விழை என்பதன் பொருள் ஆசைப்படு	RWE_M	0
விலை ஒரு மீன்வகை	விளை ஒரு மீன்வகை	RWE_M	0
விழை ஒரு மீன்வகை	விளை ஒரு மீன்வகை	RWE_M	0
விலை என்பதன் பொருள் விளைச்சல்	விளை என்பதன் பொருள் விளைச்சல்	RWE_M	0
விழை என்பதன் பொருள் விளைச்சல்	விளை என்பதன் பொருள் விளைச்சல்	RWE_M	0
விளக்கு என்பதன் பொருள் விலக்கி விடு	விலக்கு என்பதன் பொருள் விலக்கி விடு	RWE_M	0
விளக்கு என்பதன் பொருள் தவிர்	விலக்கு என்பதன் பொருள் தவிர்	RWE_M	0
விலக்கு என்பதன் பொருள் விளக்கமாகச் சொல்	விளக்கு என்பதன் பொருள் விளக்கமாகச் சொல்	RWE_M	0
விலக்கு என்பதன் பொருள் தீபம்	விளக்கு என்பதன் பொருள் தீபம்	RWE_M	0
விளங்கு என்பதன் பொருள் பூட்டு	விலங்கு என்பதன் பொருள் பூட்டு	RWE_M	0
விளங்கு என்பதன் பொருள் கை	விலங்கு என்பதன் பொருள் கை	RWE_M	0
விளங்கு என்பதன் பொருள் கைகளைப் பிணிக்கும் கருவி	விலங்கு என்பதன் பொருள் கைகளைப் பிணிக்கும் கருவி	RWE_M	0
விளங்கு என்பதன் பொருள் மிருகம்	விலங்கு என்பதன் பொருள் மிருகம்	RWE_M	0
விலங்கு என்பதன் பொருள் திகழ்தல்	விளங்கு என்பதன் பொருள் திகழ்தல்	RWE_M	0
விலங்கு என்பதன் பொருள் சிற்றரத்தை 	விளங்கு என்பதன் பொருள் சிற்றரத்தை 	RWE_M	0
வெள்ளம் என்பதன் பொருள் சக்கரைக்கட்டி	வெல்லம் என்பதன் பொருள் சக்கரைக்கட்டி	RWE_M	0
வெள்ளம் என்பதன் பொருள் கருப்பட்டி	வெல்லம் என்பதன் பொருள் கருப்பட்டி	RWE_M	0
வெல்லம் என்பதன் பொருள் மிதமிஞ்சிய நீர்பெருக்கு	வெள்ளம் என்பதன் பொருள் மிதமிஞ்சிய நீர்பெருக்கு	RWE_M	0
வேழம் என்பதன் பொருள் வேலமரம்	வேலம் என்பதன் பொருள் வேலமரம்	RWE_M	0
வேழம் என்பதன் பொருள் தோட்டம்	வேலம் என்பதன் பொருள் தோட்டம்	RWE_M	0
வேலம் என்பதன் பொருள் யானை	வேழம் என்பதன் பொருள் யானை	RWE_M	0
வேலம் என்பதன் பொருள் கரும்பு	வேழம் என்பதன் பொருள் கரும்பு	RWE_M	0
வேலம் என்பதன் பொருள் மூங்கில்	வேழம் என்பதன் பொருள் மூங்கில்	RWE_M	0
வேள் என்பதன் பொருள் வேலாயுதம்	வேல் என்பதன் பொருள் வேலாயுதம்	RWE_M	0
வேல் என்பதன் பொருள் வேளிர் குலத்தவன்	வேள் என்பதன் பொருள் வேளிர் குலத்தவன்	RWE_M	0
வேல் என்பதன் பொருள் மன்மதன	வேள் என்பதன் பொருள் மன்மதன	RWE_M	0
வேல் என்பதன் பொருள் ஆசை	வேள் என்பதன் பொருள் ஆசை	RWE_M	0
வேளை என்பதன் பொருள் பணி	வேலை என்பதன் பொருள் பணி	RWE_M	0
வேளை என்பதன் பொருள் கடல்	வேலை என்பதன் பொருள் கடல்	RWE_M	0
வேலை என்பதன் பொருள் பொழுது	வேளை என்பதன் பொருள் பொழுது	RWE_M	0
வேலை என்பதன் பொருள் நேரம்	வேளை என்பதன் பொருள் நேரம்	RWE_M	0
வேலை என்பதன் பொருள் ஒருவகைக் கீரை	வேளை என்பதன் பொருள் ஒருவகைக் கீரை	RWE_M	0
அற என்பதன் பொருள் பாம்பு	அர என்பதன் பொருள் பாம்பு	RWE_M	0
அர என்பதன் பொருள் தெளிய	அற என்பதன் பொருள் தெளிய	RWE_M	0
அர என்பதன் பொருள் முற்றுமாக	அற என்பதன் பொருள் முற்றுமாக	RWE_M	0
அறவு என்பதன் பொருள் பாம்பு	அரவு என்பதன் பொருள் பாம்பு	RWE_M	0
அரவு என்பதன் பொருள் அறுதல்	அறவு என்பதன் பொருள் அறுதல்	RWE_M	0
அரவு என்பதன் பொருள் தொலைதல்	அறவு என்பதன் பொருள் தொலைதல்	RWE_M	0
அறம் என்பதன் பொருள் ஒரு கருவி	அரம் என்பதன் பொருள் ஒரு கருவி	RWE_M	0
அரம் என்பதன் பொருள் தர்மம்	அறம் என்பதன் பொருள் தர்மம்	RWE_M	0
அரம் என்பதன் பொருள் நீதி	அறம் என்பதன் பொருள் நீதி	RWE_M	0
அரம் என்பதன் பொருள் புண்ணியம்	அறம் என்பதன் பொருள் புண்ணியம்	RWE_M	0
அரம் என்பதன் பொருள் கடமை	அறம் என்பதன் பொருள் கடமை	RWE_M	0
அரம் என்பதன் பொருள் அறநூல்	அறம் என்பதன் பொருள் அறநூல்	RWE_M	0
அரம் என்பதன் பொருள் துறவறம்	அறம் என்பதன் பொருள் துறவறம்	RWE_M	0
அறி என்பதன் பொருள் திருமால்	அரி என்பதன் பொருள் திருமால்	RWE_M	0
அறி என்பதன் பொருள் அரிசி	அரி என்பதன் பொருள் அரிசி	RWE_M	0
அறி என்பதன் பொருள் அழகு	அரி என்பதன் பொருள் அழகு	RWE_M	0
அறி என்பதன் பொருள் அரிதல்	அரி என்பதன் பொருள் அரிதல்	RWE_M	0
அறி என்பதன் பொருள் பன்றி	அரி என்பதன் பொருள் பன்றி	RWE_M	0
அறி என்பதன் பொருள் வண்டு	அரி என்பதன் பொருள் வண்டு	RWE_M	0
அறி என்பதன் பொருள் கடல்	அரி என்பதன் பொருள் கடல்	RWE_M	0
அறி என்பதன் பொருள் தகடு	அரி என்பதன் பொருள் தகடு	RWE_M	0
அறி என்பதன் பொருள் சிவன்	அரி என்பதன் பொருள் சிவன்	RWE_M	0
அறி என்பதன் பொருள் சிங்கம்.	அரி என்பதன் பொருள் சிங்கம்.	RWE_M	0
அரி என்பதன் பொருள் அறிந்துகொள்	அறி என்பதன் பொருள் அறிந்துகொள்	RWE_M	0
அறிய என்பதன் பொருள் கிடைத்தற்கு அரிதான	அரிய என்பதன் பொருள் கிடைத்தற்கு அரிதான	RWE_M	0
அறிய என்பதன் பொருள் கஷ்டமான	அரிய என்பதன் பொருள் கஷ்டமான	RWE_M	0
அரிய என்பதன் பொருள் அறிந்து கொள்ள	அறிய என்பதன் பொருள் அறிந்து கொள்ள	RWE_M	0
அரிய என்பதன் பொருள் தெரிந்து கொள்ள	அறிய என்பதன் பொருள் தெரிந்து கொள்ள	RWE_M	0
அறன் என்பதன் பொருள் சிவன்	அரன் என்பதன் பொருள் சிவன்	RWE_M	0
அரன் என்பதன் பொருள் தர்மம்	அறன் என்பதன் பொருள் தர்மம்	RWE_M	0
அரன் என்பதன் பொருள் அறக்கடவுள்	அறன் என்பதன் பொருள் அறக்கடவுள்	RWE_M	0
அறிவை என்பதன் பொருள் எட்டு வயதுக்கு மேல் இருபத்து ஐந்து வயதுக்குட்பட்ட பெண்	அரிவை என்பதன் பொருள் எட்டு வயதுக்கு மேல் இருபத்து ஐந்து வயதுக்குட்பட்ட பெண்	RWE_M	0
அரிவை என்பதன் பொருள் அறிவாய்	அறிவை என்பதன் பொருள் அறிவாய்	RWE_M	0
அறுகு என்பதன் பொருள் அருகம்புல்	அருகு என்பதன் பொருள் அருகம்புல்	RWE_M	0
அறுகு என்பதன் பொருள் அண்மை	அருகு என்பதன் பொருள் அண்மை	RWE_M	0
அருகு என்பதன் பொருள் குறைந்து போதல்	அறுகு என்பதன் பொருள் குறைந்து போதல்	RWE_M	0
அக்கறை என்பதன் பொருள் அந்தக் கரை	அக்கரை என்பதன் பொருள் அந்தக் கரை	RWE_M	0
அக்கரை என்பதன் பொருள் ஈடுபாடு	அக்கறை என்பதன் பொருள் ஈடுபாடு	RWE_M	0
அறை என்பதன் பொருள் பாதி	அரை என்பதன் பொருள் பாதி	RWE_M	0
அறை என்பதன் பொருள் மேகலை	அரை என்பதன் பொருள் மேகலை	RWE_M	0
அறை என்பதன் பொருள் வயிறு	அரை என்பதன் பொருள் வயிறு	RWE_M	0
அறை என்பதன் பொருள் ஒரு மரம்	அரை என்பதன் பொருள் ஒரு மரம்	RWE_M	0
அரை என்பதன் பொருள் வீட்டின் பகுதி	அறை என்பதன் பொருள் வீட்டின் பகுதி	RWE_M	0
அரை என்பதன் பொருள் அடி	அறை என்பதன் பொருள் அடி	RWE_M	0
அரை என்பதன் பொருள் பாத்தி	அறை என்பதன் பொருள் பாத்தி	RWE_M	0
அரை என்பதன் பொருள் ஒலி	அறை என்பதன் பொருள் ஒலி	RWE_M	0
அரை என்பதன் பொருள் பாசறை	அறை என்பதன் பொருள் பாசறை	RWE_M	0
அரை என்பதன் பொருள் சொல்	அறை என்பதன் பொருள் சொல்	RWE_M	0
அரை என்பதன் பொருள் குகை	அறை என்பதன் பொருள் குகை	RWE_M	0
அரை என்பதன் பொருள் வஞ்சனை	அறை என்பதன் பொருள் வஞ்சனை	RWE_M	0
அரை என்பதன் பொருள் மாளிகை	அறை என்பதன் பொருள் மாளிகை	RWE_M	0
அறைதல் என்பதன் பொருள் தேய்தல்	அரைதல் என்பதன் பொருள் தேய்தல்	RWE_M	0
அரைதல் என்பதன் பொருள் அடித்தல்	அறைதல் என்பதன் பொருள் அடித்தல்	RWE_M	0
அரைதல் என்பதன் பொருள் சொல்லுதல்	அறைதல் என்பதன் பொருள் சொல்லுதல்	RWE_M	0
அப்புறம் என்பதன் பொருள் அந்தப் பக்கம்	அப்புரம் என்பதன் பொருள் அந்தப் பக்கம்	RWE_M	0
அப்புரம் என்பதன் பொருள் பிறகு	அப்புறம் என்பதன் பொருள் பிறகு	RWE_M	0
அற்பணம் என்பதன் பொருள் உரித்தாக்குதல்	அர்ப்பணம் என்பதன் பொருள் உரித்தாக்குதல்	RWE_M	0
அர்ப்பணம் என்பதன் பொருள் காணிக்கை செலுத்துதல்	அற்பணம் என்பதன் பொருள் காணிக்கை செலுத்துதல்	RWE_M	0
அறு என்பதன் பொருள் உருவமற்றது	அரு என்பதன் பொருள் உருவமற்றது	RWE_M	0
அரு என்பதன் பொருள் துண்டித்து விடு	அறு என்பதன் பொருள் துண்டித்து விடு	RWE_M	0
அரு என்பதன் பொருள் அறுத்து விடு	அறு என்பதன் பொருள் அறுத்து விடு	RWE_M	0
அறுமை என்பதன் பொருள் சிறப்பு	அருமை என்பதன் பொருள் சிறப்பு	RWE_M	0
அறுமை என்பதன் பொருள் அன்பு	அருமை என்பதன் பொருள் அன்பு	RWE_M	0
அறுமை என்பதன் பொருள் இன்மை	அருமை என்பதன் பொருள் இன்மை	RWE_M	0
அறுமை என்பதன் பொருள் சுலபத்தில் கிடைக்காதது	அருமை என்பதன் பொருள் சுலபத்தில் கிடைக்காதது	RWE_M	0
அருமை என்பதன் பொருள் நிலையின்மை	அறுமை என்பதன் பொருள் நிலையின்மை	RWE_M	0
அருமை என்பதன் பொருள் ஆறு	அறுமை என்பதன் பொருள் ஆறு	RWE_M	0
ஆறு என்பதன் பொருள் குடம்	ஆரு என்பதன் பொருள் குடம்	RWE_M	0
ஆறு என்பதன் பொருள் நண்டு	ஆரு என்பதன் பொருள் நண்டு	RWE_M	0
ஆரு என்பதன் பொருள் ஒரு எண்	ஆறு என்பதன் பொருள் ஒரு எண்	RWE_M	0
ஆரு என்பதன் பொருள் வழி	ஆறு என்பதன் பொருள் வழி	RWE_M	0
ஆரு என்பதன் பொருள் சமயம்	ஆறு என்பதன் பொருள் சமயம்	RWE_M	0
ஆரு என்பதன் பொருள் தன்மை	ஆறு என்பதன் பொருள் தன்மை	RWE_M	0
ஆரு என்பதன் பொருள் நதி	ஆறு என்பதன் பொருள் நதி	RWE_M	0
ஆரு என்பதன் பொருள் ஒழுக்கம்	ஆறு என்பதன் பொருள் ஒழுக்கம்	RWE_M	0
ஆரு என்பதன் பொருள் பக்கம்	ஆறு என்பதன் பொருள் பக்கம்	RWE_M	0
ஆரு என்பதன் பொருள் நிலை	ஆறு என்பதன் பொருள் நிலை	RWE_M	0
ஆற என்பதன் பொருள் நிறைய	ஆர என்பதன் பொருள் நிறைய	RWE_M	0
ஆற என்பதன் பொருள் அனுபவிக்க	ஆர என்பதன் பொருள் அனுபவிக்க	RWE_M	0
ஆர என்பதன் பொருள் சூடு குறைய	ஆற என்பதன் பொருள் சூடு குறைய	RWE_M	0
ஆறல் ஒருவகை மீன்	ஆரல் ஒருவகை மீன்	RWE_M	0
ஆரல் என்பதன் பொருள் சூடு குறைதல்	ஆறல் என்பதன் பொருள் சூடு குறைதல்	RWE_M	0
இறத்தல் என்பதன் பொருள் யாசித்தல்	இரத்தல் என்பதன் பொருள் யாசித்தல்	RWE_M	0
இரத்தல் என்பதன் பொருள் இறந்துபோதல்	இறத்தல் என்பதன் பொருள் இறந்துபோதல்	RWE_M	0
இரத்தல் என்பதன் பொருள் சாதல்	இறத்தல் என்பதன் பொருள் சாதல்	RWE_M	0
இறகு என்பதன் பொருள் சூரியன்	இரகு என்பதன் பொருள் சூரியன்	RWE_M	0
இறகு என்பதன் பொருள் சிறகு	இறகு என்பதன் பொருள் சிறகு	RWE_M	0
இறக்கம் என்பதன் பொருள் கருணை	இரக்கம் என்பதன் பொருள் கருணை	RWE_M	0
இரக்கம் என்பதன் பொருள் சரிவு	இறக்கம் என்பதன் பொருள் சரிவு	RWE_M	0
இரக்கம் என்பதன் பொருள் மரணம்	இறக்கம் என்பதன் பொருள் மரணம்	RWE_M	0
இறங்கு என்பதன் பொருள் கருணைகாட்டு	இரங்கு என்பதன் பொருள் கருணைகாட்டு	RWE_M	0
இரங்கு என்பதன் பொருள் கீழிறங்கி வா	இறங்கு என்பதன் பொருள் கீழிறங்கி வா	RWE_M	0
இறவம் என்பதன் பொருள் இரவு	இரவம் என்பதன் பொருள் இரவு	RWE_M	0
இரவம் என்பதன் பொருள் இறால் மீன்	இறவம் என்பதன் பொருள் இறால் மீன்	RWE_M	0
இறவி என்பதன் பொருள் சூரியன்	இரவி என்பதன் பொருள் சூரியன்	RWE_M	0
இறவி என்பதன் பொருள் எருக்கு	இரவி என்பதன் பொருள் எருக்கு	RWE_M	0
இறவி என்பதன் பொருள் மலை	இரவி என்பதன் பொருள் மலை	RWE_M	0
இறவி என்பதன் பொருள் வாணிகத்தொழில்	இரவி என்பதன் பொருள் வாணிகத்தொழில்	RWE_M	0
இரவி என்பதன் பொருள் இறத்தல்	இறவி என்பதன் பொருள் இறத்தல்	RWE_M	0
இறவு என்பதன் பொருள் இரவு நேரம்	இரவு என்பதன் பொருள் இரவு நேரம்	RWE_M	0
இறவு என்பதன் பொருள் யாசித்தல்	இரவு என்பதன் பொருள் யாசித்தல்	RWE_M	0
இரவு என்பதன் பொருள் மிகுதி	இறவு என்பதன் பொருள் மிகுதி	RWE_M	0
இரவு என்பதன் பொருள் இறால்மீன்	இறவு என்பதன் பொருள் இறால்மீன்	RWE_M	0
இரவு என்பதன் பொருள் இறுதி	இறவு என்பதன் பொருள் இறுதி	RWE_M	0
இரவு என்பதன் பொருள் தேன்கூடு	இறவு என்பதன் பொருள் தேன்கூடு	RWE_M	0
இரவு என்பதன் பொருள் சாவு	இறவு என்பதன் பொருள் சாவு	RWE_M	0
இரவு என்பதன் பொருள் முடிவு	இறவு என்பதன் பொருள் முடிவு	RWE_M	0
இரவு என்பதன் பொருள் நீக்கம்	இறவு என்பதன் பொருள் நீக்கம்	RWE_M	0
இறை என்பதன் பொருள் ஒலி	இரை என்பதன் பொருள் ஒலி	RWE_M	0
இறை என்பதன் பொருள் உணவு	இரை என்பதன் பொருள் உணவு	RWE_M	0
இரை என்பதன் பொருள் கடவுள்	இறை என்பதன் பொருள் கடவுள்	RWE_M	0
இரை என்பதன் பொருள் அணு	இறை என்பதன் பொருள் அணு	RWE_M	0
இரை என்பதன் பொருள் அரசன்	இறை என்பதன் பொருள் அரசன்	RWE_M	0
இரை என்பதன் பொருள் ரேகை	இறை என்பதன் பொருள் ரேகை	RWE_M	0
இரை என்பதன் பொருள் சந்து	இறை என்பதன் பொருள் சந்து	RWE_M	0
இரை என்பதன் பொருள் கடமை	இறை என்பதன் பொருள் கடமை	RWE_M	0
இரை என்பதன் பொருள் தலைமை	இறை என்பதன் பொருள் தலைமை	RWE_M	0
இரை என்பதன் பொருள் விடை	இறை என்பதன் பொருள் விடை	RWE_M	0
இரை என்பதன் பொருள் உயரம்	இறை என்பதன் பொருள் உயரம்	RWE_M	0
இரை என்பதன் பொருள் மூலை	இறை என்பதன் பொருள் மூலை	RWE_M	0
இறு என்பதன் பொருள் இரண்டு	இரு என்பதன் பொருள் இரண்டு	RWE_M	0
இறு என்பதன் பொருள் பெரிய	இரு என்பதன் பொருள் பெரிய	RWE_M	0
இறு என்பதன் பொருள் உட்கார்	இரு என்பதன் பொருள் உட்கார்	RWE_M	0
இறு என்பதன் பொருள் அமர்ந்துகொள்	இரு என்பதன் பொருள் அமர்ந்துகொள்	RWE_M	0
இரு என்பதன் பொருள் ஒடி	இறு என்பதன் பொருள் ஒடி	RWE_M	0
இரு என்பதன் பொருள் கெடு	இறு என்பதன் பொருள் கெடு	RWE_M	0
இரு என்பதன் பொருள் சொல்லு	இறு என்பதன் பொருள் சொல்லு	RWE_M	0
இறும்பு என்பதன் பொருள் கடிவாளம்	இரும்பு என்பதன் பொருள் கடிவாளம்	RWE_M	0
இறும்பு என்பதன் பொருள் கிம்புரி	இரும்பு என்பதன் பொருள் கிம்புரி	RWE_M	0
இறும்பு என்பதன் பொருள் ஆயுதம்	இரும்பு என்பதன் பொருள் ஆயுதம்	RWE_M	0
இறும்பு என்பதன் பொருள் ஓர் உலோகம்	இரும்பு என்பதன் பொருள் ஓர் உலோகம்	RWE_M	0
இரும்பு என்பதன் பொருள் வண்டு	இறும்பு என்பதன் பொருள் வண்டு	RWE_M	0
இரும்பு என்பதன் பொருள் சிறுமலை	இறும்பு என்பதன் பொருள் சிறுமலை	RWE_M	0
இறுப்பு என்பதன் பொருள் கையிருப்பு	இருப்பு என்பதன் பொருள் கையிருப்பு	RWE_M	0
இறுப்பு என்பதன் பொருள் இருப்பிடம்	இருப்பு என்பதன் பொருள் இருப்பிடம்	RWE_M	0
இறுப்பு என்பதன் பொருள் ஆசனம்	இருப்பு என்பதன் பொருள் ஆசனம்	RWE_M	0
இறுப்பு என்பதன் பொருள் நிலை	இருப்பு என்பதன் பொருள் நிலை	RWE_M	0
இறுப்பு என்பதன் பொருள் பொருள்	இருப்பு என்பதன் பொருள் பொருள்	RWE_M	0
இறுப்பு என்பதன் பொருள் முதல்	இருப்பு என்பதன் பொருள் முதல்	RWE_M	0
இருப்பு என்பதன் பொருள் வடிப்பு	இறுப்பு என்பதன் பொருள் வடிப்பு	RWE_M	0
இறுத்தல் என்பதன் பொருள் அமர்ந்திருத்தல்	இருத்தல் என்பதன் பொருள் அமர்ந்திருத்தல்	RWE_M	0
இறுத்தல் என்பதன் பொருள் காத்திருத்தல்	இருத்தல் என்பதன் பொருள் காத்திருத்தல்	RWE_M	0
இருத்தல் என்பதன் பொருள் வடித்தல்	இறுத்தல் என்பதன் பொருள் வடித்தல்	RWE_M	0
இருத்தல் என்பதன் பொருள் செலுத்தல்	இறுத்தல் என்பதன் பொருள் செலுத்தல்	RWE_M	0
இருத்தல் என்பதன் பொருள் எறிதல்	இறுத்தல் என்பதன் பொருள் எறிதல்	RWE_M	0
இருத்தல் என்பதன் பொருள் கடன் கொடுத்தல்	இறுத்தல் என்பதன் பொருள் கடன் கொடுத்தல்	RWE_M	0
இருத்தல் என்பதன் பொருள் பதில்கூறல்	இறுத்தல் என்பதன் பொருள் பதில்கூறல்	RWE_M	0
இருத்தல் என்பதன் பொருள் முடித்தல்	இறுத்தல் என்பதன் பொருள் முடித்தல்	RWE_M	0
இருத்தல் என்பதன் பொருள் முறித்தல்	இறுத்தல் என்பதன் பொருள் முறித்தல்	RWE_M	0
இறுக்கு என்பதன் பொருள் மந்திரம்	இருக்கு என்பதன் பொருள் மந்திரம்	RWE_M	0
இறுக்கு என்பதன் பொருள் ரிக் வேதம்	இருக்கு என்பதன் பொருள் ரிக் வேதம்	RWE_M	0
இருக்கு என்பதன் பொருள் அழுத்து	இறுக்கு என்பதன் பொருள் அழுத்து	RWE_M	0
இருக்கு என்பதன் பொருள் இறுக்கிக்கட்டு	இறுக்கு என்பதன் பொருள் இறுக்கிக்கட்டு	RWE_M	0
இறைத்தல் என்பதன் பொருள் ஒலித்தல்	இரைத்தல் என்பதன் பொருள் ஒலித்தல்	RWE_M	0
இறைத்தல் என்பதன் பொருள் மூச்சுவாங்குதல்	இரைத்தல் என்பதன் பொருள் மூச்சுவாங்குதல்	RWE_M	0
இரைத்தல் என்பதன் பொருள் சிதறுதல்	இறைத்தல் என்பதன் பொருள் சிதறுதல்	RWE_M	0
இரைத்தல் என்பதன் பொருள் மிகு செலவு	இறைத்தல் என்பதன் பொருள் மிகு செலவு	RWE_M	0
உறவு என்பதன் பொருள் அறிவு	உரவு என்பதன் பொருள் அறிவு	RWE_M	0
உறவு என்பதன் பொருள் ஒலி	உரவு என்பதன் பொருள் ஒலி	RWE_M	0
உறவு என்பதன் பொருள் மிகுதி	உரவு என்பதன் பொருள் மிகுதி	RWE_M	0
உறவு என்பதன் பொருள் வலி	உரவு என்பதன் பொருள் வலி	RWE_M	0
உறவு என்பதன் பொருள் ஞானம்	உரவு என்பதன் பொருள் ஞானம்	RWE_M	0
உறவு என்பதன் பொருள் விடம்	உரவு என்பதன் பொருள் விடம்	RWE_M	0
உரவு என்பதன் பொருள் நட்பு	உறவு என்பதன் பொருள் நட்பு	RWE_M	0
உரவு என்பதன் பொருள் சுற்றம்	உறவு என்பதன் பொருள் சுற்றம்	RWE_M	0
உரவு என்பதன் பொருள் எறும்பு	உறவு என்பதன் பொருள் எறும்பு	RWE_M	0
உறவோர் என்பதன் பொருள் அறிஞர்	உரவோர் என்பதன் பொருள் அறிஞர்	RWE_M	0
உறவோர் என்பதன் பொருள் முனிவர்	உரவோர் என்பதன் பொருள் முனிவர்	RWE_M	0
உரவோர் என்பதன் பொருள் சுற்றத்தார்	உறவோர் என்பதன் பொருள் சுற்றத்தார்	RWE_M	0
உரவோர் என்பதன் பொருள் அடைந்தோர்	உறவோர் என்பதன் பொருள் அடைந்தோர்	RWE_M	0
உறி என்பதன் பொருள் தோல்	உரி என்பதன் பொருள் தோல்	RWE_M	0
உறி என்பதன் பொருள் மரப்பட்டை	உரி என்பதன் பொருள் மரப்பட்டை	RWE_M	0
உறி என்பதன் பொருள் அரைப்படியளவு	உரி என்பதன் பொருள் அரைப்படியளவு	RWE_M	0
உறி என்பதன் பொருள் உரிச்சொல்	உரி என்பதன் பொருள் உரிச்சொல்	RWE_M	0
உறி என்பதன் பொருள் கொத்துமல்லி	உரி என்பதன் பொருள் கொத்துமல்லி	RWE_M	0
உரி என்பதன் பொருள் உறிவெண்ணெய்	உறி என்பதன் பொருள் உறிவெண்ணெய்	RWE_M	0
உரி என்பதன் பொருள் தூக்கு	உறி என்பதன் பொருள் தூக்கு	RWE_M	0
உறு என்பதன் பொருள் வடிவம்	உரு என்பதன் பொருள் வடிவம்	RWE_M	0
உறு என்பதன் பொருள் அழகு	உரு என்பதன் பொருள் அழகு	RWE_M	0
உறு என்பதன் பொருள் உடல்	உரு என்பதன் பொருள் உடல்	RWE_M	0
உறு என்பதன் பொருள் மரக்கலம்	உரு என்பதன் பொருள் மரக்கலம்	RWE_M	0
உறு என்பதன் பொருள் நிறம்	உரு என்பதன் பொருள் நிறம்	RWE_M	0
உறு என்பதன் பொருள் அச்சம்	உரு என்பதன் பொருள் அச்சம்	RWE_M	0
உறு என்பதன் பொருள் பெருமை	உரு என்பதன் பொருள் பெருமை	RWE_M	0
உறு என்பதன் பொருள் மேன்மை	உரு என்பதன் பொருள் மேன்மை	RWE_M	0
உரு என்பதன் பொருள் மிகுதி	உறு என்பதன் பொருள் மிகுதி	RWE_M	0
உறுக்குதல் என்பதன் பொருள் இளக்குதல்	உருக்குதல் என்பதன் பொருள் இளக்குதல்	RWE_M	0
உறுக்குதல் என்பதன் பொருள் மெலியச் செய்தல்	உருக்குதல் என்பதன் பொருள் மெலியச் செய்தல்	RWE_M	0
உருக்குதல் என்பதன் பொருள் சினத்தல்	உறுக்குதல் என்பதன் பொருள் சினத்தல்	RWE_M	0
உருக்குதல் என்பதன் பொருள் அதட்டுதல்	உறுக்குதல் என்பதன் பொருள் அதட்டுதல்	RWE_M	0
உறை என்பதன் பொருள் புகழ்	உரை என்பதன் பொருள் புகழ்	RWE_M	0
உறை என்பதன் பொருள் விளக்கவுரை	உரை என்பதன் பொருள் விளக்கவுரை	RWE_M	0
உறை என்பதன் பொருள் நூல்	உரை என்பதன் பொருள் நூல்	RWE_M	0
உறை என்பதன் பொருள் பொன்மாற்று	உரை என்பதன் பொருள் பொன்மாற்று	RWE_M	0
உறை என்பதன் பொருள் அறிவுரை	உரை என்பதன் பொருள் அறிவுரை	RWE_M	0
உறை என்பதன் பொருள் சொல்	உரை என்பதன் பொருள் சொல்	RWE_M	0
உரை என்பதன் பொருள் இடம்	உறை என்பதன் பொருள் இடம்	RWE_M	0
உரை என்பதன் பொருள் பண்டம்	உறை என்பதன் பொருள் பண்டம்	RWE_M	0
உரை என்பதன் பொருள் பொருள்	உறை என்பதன் பொருள் பொருள்	RWE_M	0
உரை என்பதன் பொருள் மருந்து	உறை என்பதன் பொருள் மருந்து	RWE_M	0
உரை என்பதன் பொருள் பாலில் இடும் பிரை	உறை என்பதன் பொருள் பாலில் இடும் பிரை	RWE_M	0
உரை என்பதன் பொருள் துளி	உறை என்பதன் பொருள் துளி	RWE_M	0
உரை என்பதன் பொருள் மழை	உறை என்பதன் பொருள் மழை	RWE_M	0
உரை என்பதன் பொருள் ஆடை	உறை என்பதன் பொருள் ஆடை	RWE_M	0
உரை என்பதன் பொருள் துன்பம்	உறை என்பதன் பொருள் துன்பம்	RWE_M	0
உரை என்பதன் பொருள் பாம்பின் விஷப்பை	உறை என்பதன் பொருள் பாம்பின் விஷப்பை	RWE_M	0
உறைப்பு என்பதன் பொருள் தங்குதல்	உரைப்பு என்பதன் பொருள் தங்குதல்	RWE_M	0
உறைப்பு என்பதன் பொருள் தோய்தல்	உரைப்பு என்பதன் பொருள் தோய்தல்	RWE_M	0
உரைப்பு என்பதன் பொருள் காரம்	உறைப்பு என்பதன் பொருள் காரம்	RWE_M	0
உரைப்பு என்பதன் பொருள் கொடுமை	உறைப்பு என்பதன் பொருள் கொடுமை	RWE_M	0
உறையல் என்பதன் பொருள் சொல்லல்	உரையல் என்பதன் பொருள் சொல்லல்	RWE_M	0
உரையல் என்பதன் பொருள் மாறுபாடு	உறையல் என்பதன் பொருள் மாறுபாடு	RWE_M	0
உரையல் என்பதன் பொருள் பிணக்கு	உறையல் என்பதன் பொருள் பிணக்கு	RWE_M	0
உறிய என்பதன் பொருள் உரிமையான	உரிய என்பதன் பொருள் உரிமையான	RWE_M	0
உரிய என்பதன் பொருள் உறிஞ்ச	உறிய என்பதன் பொருள் உறிஞ்ச	RWE_M	0
ஊறல் என்பதன் பொருள் ஊர்தல்	ஊரல் என்பதன் பொருள் ஊர்தல்	RWE_M	0
ஊறல் என்பதன் பொருள் கிளிஞ்சல்	ஊரல் என்பதன் பொருள் கிளிஞ்சல்	RWE_M	0
ஊறல் என்பதன் பொருள் ஒருவகைப் பறவை	ஊரல் என்பதன் பொருள் ஒருவகைப் பறவை	RWE_M	0
ஊரல் என்பதன் பொருள் தினவு	ஊறல் என்பதன் பொருள் தினவு	RWE_M	0
ஊரல் என்பதன் பொருள் ஊற்று	ஊறல் என்பதன் பொருள் ஊற்று	RWE_M	0
ஊரல் என்பதன் பொருள் சாறு	ஊறல் என்பதன் பொருள் சாறு	RWE_M	0
ஊரல் என்பதன் பொருள் வருவாய்	ஊறல் என்பதன் பொருள் வருவாய்	RWE_M	0
ஊரல் என்பதன் பொருள் ஊறுதல்	ஊறல் என்பதன் பொருள் ஊறுதல்	RWE_M	0
ஊரல் என்பதன் பொருள் களிப்பு	ஊறல் என்பதன் பொருள் களிப்பு	RWE_M	0
ஊறு என்பதன் பொருள் அச்சம்	ஊரு என்பதன் பொருள் அச்சம்	RWE_M	0
ஊறு என்பதன் பொருள் தொடை	ஊரு என்பதன் பொருள் தொடை	RWE_M	0
ஊரு என்பதன் பொருள் இடையூறு	ஊறு என்பதன் பொருள் இடையூறு	RWE_M	0
ஊரு என்பதன் பொருள் துன்பம்	ஊறு என்பதன் பொருள் துன்பம்	RWE_M	0
ஊரு என்பதன் பொருள் காயம் உறுதல்	ஊறு என்பதன் பொருள் காயம் உறுதல்	RWE_M	0
ஊரு என்பதன் பொருள் தீண்டல்	ஊறு என்பதன் பொருள் தீண்டல்	RWE_M	0
ஊரு என்பதன் பொருள் குற்றம்	ஊறு என்பதன் பொருள் குற்றம்	RWE_M	0
ஊரு என்பதன் பொருள் புண்	ஊறு என்பதன் பொருள் புண்	RWE_M	0
ஊரு என்பதன் பொருள் கொலை	ஊறு என்பதன் பொருள் கொலை	RWE_M	0
எறி என்பதன் பொருள் தீ	எரி என்பதன் பொருள் தீ	RWE_M	0
எறி என்பதன் பொருள் கார்த்திகை	எரி என்பதன் பொருள் கார்த்திகை	RWE_M	0
எறி என்பதன் பொருள் பிரபை	எரி என்பதன் பொருள் பிரபை	RWE_M	0
எறி என்பதன் பொருள் இடபராசி	எரி என்பதன் பொருள் இடபராசி	RWE_M	0
எறி என்பதன் பொருள் நெருப்பு	எரி என்பதன் பொருள் நெருப்பு	RWE_M	0
எறி என்பதன் பொருள் நரகம்	எரி என்பதன் பொருள் நரகம்	RWE_M	0
எறி என்பதன் பொருள் வெம்மை	எரி என்பதன் பொருள் வெம்மை	RWE_M	0
எறி என்பதன் பொருள் கந்தகம்	எரி என்பதன் பொருள் கந்தகம்	RWE_M	0
எரி என்பதன் பொருள் விடுதல்	எறி என்பதன் பொருள் விடுதல்	RWE_M	0
எரி என்பதன் பொருள் எறிதல்	எறி என்பதன் பொருள் எறிதல்	RWE_M	0
எரி என்பதன் பொருள் குறிப்பாகக் கூறுதல்	எறி என்பதன் பொருள் குறிப்பாகக் கூறுதல்	RWE_M	0
ஏற என்பதன் பொருள் ஓர் உவம உருபு	ஏர என்பதன் பொருள் ஓர் உவம உருபு	RWE_M	0
ஏர என்பதன் பொருள் மிகுதி	ஏற என்பதன் பொருள் மிகுதி	RWE_M	0
ஏர என்பதன் பொருள் உயர ஏறுதல்	ஏற என்பதன் பொருள் உயர ஏறுதல்	RWE_M	0
ஏறி என்பதன் பொருள் நீர்நிலை	ஏரி என்பதன் பொருள் நீர்நிலை	RWE_M	0
ஏறி என்பதன் பொருள் குளம்	ஏரி என்பதன் பொருள் குளம்	RWE_M	0
ஏரி என்பதன் பொருள் உயர்ந்த	ஏறி என்பதன் பொருள் உயர்ந்த	RWE_M	0
ஏரி என்பதன் பொருள் மேலே ஏறி	ஏறி என்பதன் பொருள் மேலே ஏறி	RWE_M	0
ஒறு என்பதன் பொருள் ஒன்று	ஒரு என்பதன் பொருள் ஒன்று	RWE_M	0
ஒறு என்பதன் பொருள் ஒப்பற்ற	ஒரு என்பதன் பொருள் ஒப்பற்ற	RWE_M	0
ஒறு என்பதன் பொருள் ஆடு	ஒரு என்பதன் பொருள் ஆடு	RWE_M	0
ஒரு என்பதன் பொருள் தண்டி	ஒறு என்பதன் பொருள் தண்டி	RWE_M	0
ஒரு என்பதன் பொருள் அழி	ஒறு என்பதன் பொருள் அழி	RWE_M	0
ஒரு என்பதன் பொருள் இகழ்	ஒறு என்பதன் பொருள் இகழ்	RWE_M	0
ஒறுத்தல் என்பதன் பொருள் ஆண் விலங்குகளின் பொதுப்பெயர்	ஒருத்தல் என்பதன் பொருள் ஆண் விலங்குகளின் பொதுப்பெயர்	RWE_M	0
ஒருத்தல் என்பதன் பொருள் தண்டித்தல்	ஒறுத்தல் என்பதன் பொருள் தண்டித்தல்	RWE_M	0
ஒருத்தல் என்பதன் பொருள் துன்புறுத்தல்	ஒறுத்தல் என்பதன் பொருள் துன்புறுத்தல்	RWE_M	0
ஒருத்தல் என்பதன் பொருள் வருத்துதல்	ஒறுத்தல் என்பதன் பொருள் வருத்துதல்	RWE_M	0
ஒருத்தல் என்பதன் பொருள் வெறுத்தல்	ஒறுத்தல் என்பதன் பொருள் வெறுத்தல்	RWE_M	0
ஒருத்தல் என்பதன் பொருள் கடிதல்	ஒறுத்தல் என்பதன் பொருள் கடிதல்	RWE_M	0
ஒருத்தல் என்பதன் பொருள் இகழ்தல்	ஒறுத்தல் என்பதன் பொருள் இகழ்தல்	RWE_M	0
ஒருத்தல் என்பதன் பொருள் குறைத்தல்	ஒறுத்தல் என்பதன் பொருள் குறைத்தல்	RWE_M	0
ஒறுவு என்பதன் பொருள் நீங்கு	ஒருவு என்பதன் பொருள் நீங்கு	RWE_M	0
ஒருவு என்பதன் பொருள் வருத்தம்	ஒறுவு என்பதன் பொருள் வருத்தம்	RWE_M	0
ஒருவு என்பதன் பொருள் துன்பம்	ஒறுவு என்பதன் பொருள் துன்பம்	RWE_M	0
கறடு என்பதன் பொருள் மரக்கணு	கரடு என்பதன் பொருள் மரக்கணு	RWE_M	0
கறடு என்பதன் பொருள் மணிக்கட்டு	கரடு என்பதன் பொருள் மணிக்கட்டு	RWE_M	0
கறடு என்பதன் பொருள் முருடு	கரடு என்பதன் பொருள் முருடு	RWE_M	0
கறடு என்பதன் பொருள் வளர்ச்சியற்றது	கரடு என்பதன் பொருள் வளர்ச்சியற்றது	RWE_M	0
கரடு என்பதன் பொருள் தரமற்ற முத்து	கறடு என்பதன் பொருள் தரமற்ற முத்து	RWE_M	0
கறம் என்பதன் பொருள் கிரணம்	கரம் என்பதன் பொருள் கிரணம்	RWE_M	0
கறம் என்பதன் பொருள் விஷம்	கரம் என்பதன் பொருள் விஷம்	RWE_M	0
கறம் என்பதன் பொருள் செயல்	கரம் என்பதன் பொருள் செயல்	RWE_M	0
கறம் என்பதன் பொருள் கை	கரம் என்பதன் பொருள் கை	RWE_M	0
கறம் என்பதன் பொருள் கழுதை	கரம் என்பதன் பொருள் கழுதை	RWE_M	0
கரம் என்பதன் பொருள் கொடுமை	கறம் என்பதன் பொருள் கொடுமை	RWE_M	0
கரம் என்பதன் பொருள் வன்செய்கை	கறம் என்பதன் பொருள் வன்செய்கை	RWE_M	0
கறவு என்பதன் பொருள் பொய்	கரவு என்பதன் பொருள் பொய்	RWE_M	0
கறவு என்பதன் பொருள் வஞ்சனை	கரவு என்பதன் பொருள் வஞ்சனை	RWE_M	0
கறவு என்பதன் பொருள் மறைவு	கரவு என்பதன் பொருள் மறைவு	RWE_M	0
கரவு என்பதன் பொருள் கப்பம்	கறவு என்பதன் பொருள் கப்பம்	RWE_M	0
கறவை என்பதன் பொருள் கம்மாளர் கருவி	கரவை என்பதன் பொருள் கம்மாளர் கருவி	RWE_M	0
கரவை என்பதன் பொருள் பாற்பசு	கறவை என்பதன் பொருள் பாற்பசு	RWE_M	0
கறி என்பதன் பொருள் அடுப்புக்கரி	கரி என்பதன் பொருள் அடுப்புக்கரி	RWE_M	0
கறி என்பதன் பொருள் நிலக்கரி	கரி என்பதன் பொருள் நிலக்கரி	RWE_M	0
கறி என்பதன் பொருள் யானை	கரி என்பதன் பொருள் யானை	RWE_M	0
கறி என்பதன் பொருள் சாட்சி	கரி என்பதன் பொருள் சாட்சி	RWE_M	0
கறி என்பதன் பொருள் பெண் கழுதை	கரி என்பதன் பொருள் பெண் கழுதை	RWE_M	0
கறி என்பதன் பொருள் விஷம்	கரி என்பதன் பொருள் விஷம்	RWE_M	0
கறி என்பதன் பொருள் கருமை	கரி என்பதன் பொருள் கருமை	RWE_M	0
கரி என்பதன் பொருள் இறைச்சி	கறி என்பதன் பொருள் இறைச்சி	RWE_M	0
கரி என்பதன் பொருள் மிளகு	கறி என்பதன் பொருள் மிளகு	RWE_M	0
கறத்தல் என்பதன் பொருள் மறைத்தல்	கரத்தல் என்பதன் பொருள் மறைத்தல்	RWE_M	0
கரத்தல் என்பதன் பொருள் கவர்தல்	கறத்தல் என்பதன் பொருள் கவர்தல்	RWE_M	0
கரத்தல் என்பதன் பொருள் பால் கறத்தல்	கறத்தல் என்பதன் பொருள் பால் கறத்தல்	RWE_M	0
கறுத்து என்பதன் பொருள் எண்ணம்	கருத்து என்பதன் பொருள் எண்ணம்	RWE_M	0
கருத்து என்பதன் பொருள் கருநிறங்கொண்டு	கறுத்து என்பதன் பொருள் கருநிறங்கொண்டு	RWE_M	0
கறு என்பதன் பொருள் சினை	கரு என்பதன் பொருள் சினை	RWE_M	0
கறு என்பதன் பொருள் பிறவி	கரு என்பதன் பொருள் பிறவி	RWE_M	0
கறு என்பதன் பொருள் முட்டை	கரு என்பதன் பொருள் முட்டை	RWE_M	0
கறு என்பதன் பொருள் நடு	கரு என்பதன் பொருள் நடு	RWE_M	0
கறு என்பதன் பொருள் கருநிறம்	கரு என்பதன் பொருள் கருநிறம்	RWE_M	0
கறு என்பதன் பொருள் அணு	கரு என்பதன் பொருள் அணு	RWE_M	0
கறு என்பதன் பொருள் அடிப்படை	கரு என்பதன் பொருள் அடிப்படை	RWE_M	0
கரு என்பதன் பொருள் சினம்	கறு என்பதன் பொருள் சினம்	RWE_M	0
கரு என்பதன் பொருள் வைராக்கியம்	கறு என்பதன் பொருள் வைராக்கியம்	RWE_M	0
கரு என்பதன் பொருள் கோபம்	கறு என்பதன் பொருள் கோபம்	RWE_M	0
கரு என்பதன் பொருள் அகங்காரம்	கறு என்பதன் பொருள் அகங்காரம்	RWE_M	0
கறுப்பு என்பதன் பொருள் பஞ்சம்	கருப்பு என்பதன் பொருள் பஞ்சம்	RWE_M	0
கருப்பு என்பதன் பொருள் கருநிறம்	கறுப்பு என்பதன் பொருள் கருநிறம்	RWE_M	0
கருப்பு என்பதன் பொருள் பேய்	கறுப்பு என்பதன் பொருள் பேய்	RWE_M	0
கருப்பு என்பதன் பொருள் கோபம்	கறுப்பு என்பதன் பொருள் கோபம்	RWE_M	0
கருப்பு என்பதன் பொருள் குற்றம்	கறுப்பு என்பதன் பொருள் குற்றம்	RWE_M	0
கருப்பு என்பதன் பொருள் கறை	கறுப்பு என்பதன் பொருள் கறை	RWE_M	0
கறை என்பதன் பொருள் எல்லை	கரை என்பதன் பொருள் எல்லை	RWE_M	0
கறை என்பதன் பொருள் தடுப்பு	கரை என்பதன் பொருள் தடுப்பு	RWE_M	0
கறை என்பதன் பொருள் ஓரம்	கரை என்பதன் பொருள் ஓரம்	RWE_M	0
கரை என்பதன் பொருள் அழுக்கு	கறை என்பதன் பொருள் அழுக்கு	RWE_M	0
கரை என்பதன் பொருள் குற்றம்	கறை என்பதன் பொருள் குற்றம்	RWE_M	0
கரை என்பதன் பொருள் ரத்தம்	கறை என்பதன் பொருள் ரத்தம்	RWE_M	0
கறையான் என்பதன் பொருள் மீனவன்	கரையான் என்பதன் பொருள் மீனவன்	RWE_M	0
கரையான் ஓர் உயிரி	கறையான் ஓர் உயிரி	RWE_M	0
கற்பம் என்பதன் பொருள் கருவுறுதல்	கர்ப்பம் என்பதன் பொருள் கருவுறுதல்	RWE_M	0
கற்பம் என்பதன் பொருள் உள்	கர்ப்பம் என்பதன் பொருள் உள்	RWE_M	0
கற்பம் என்பதன் பொருள் சினை	கர்ப்பம் என்பதன் பொருள் சினை	RWE_M	0
கர்ப்பம் என்பதன் பொருள் கஞ்சா	கற்பம் என்பதன் பொருள் கஞ்சா	RWE_M	0
கர்ப்பம் என்பதன் பொருள் அற்பம்	கற்பம் என்பதன் பொருள் அற்பம்	RWE_M	0
கர்ப்பம் என்பதன் பொருள் ஊழிக்காலம்	கற்பம் என்பதன் பொருள் ஊழிக்காலம்	RWE_M	0
கர்ப்பம் என்பதன் பொருள் தேவலோகம்	கற்பம் என்பதன் பொருள் தேவலோகம்	RWE_M	0
கர்ப்பம் என்பதன் பொருள் திருநீறு	கற்பம் என்பதன் பொருள் திருநீறு	RWE_M	0
கர்ப்பம் என்பதன் பொருள் ஆயுள்	கற்பம் என்பதன் பொருள் ஆயுள்	RWE_M	0
கர்ப்பம் என்பதன் பொருள் மந்திர சாஸ்திரம்	கற்பம் என்பதன் பொருள் மந்திர சாஸ்திரம்	RWE_M	0
கர்ப்பம் என்பதன் பொருள் 432 கோடி	கற்பம் என்பதன் பொருள் 432 கோடி	RWE_M	0
கர்ப்பம் என்பதன் பொருள் மூப்பு நீக்கும் மருந்து	கற்பம் என்பதன் பொருள் மூப்பு நீக்கும் மருந்து	RWE_M	0
கற்பூரம் என்பதன் பொருள் சூடம்	கர்ப்பூரம் என்பதன் பொருள் சூடம்	RWE_M	0
கற்பூரம் என்பதன் பொருள் பொன்	கர்ப்பூரம் என்பதன் பொருள் பொன்	RWE_M	0
கற்பூரம் என்பதன் பொருள் மருந்து	கர்ப்பூரம் என்பதன் பொருள் மருந்து	RWE_M	0
கற்பூரம் என்பதன் பொருள் கூடம்	கர்ப்பூரம் என்பதன் பொருள் கூடம்	RWE_M	0
கர்ப்பூரம் என்பதன் பொருள் பொன்னாங்கண்ணி	கற்பூரம் என்பதன் பொருள் பொன்னாங்கண்ணி	RWE_M	0
காறி என்பதன் பொருள் கரிக்குருவி	காரி என்பதன் பொருள் கரிக்குருவி	RWE_M	0
காறி என்பதன் பொருள் காக்கை	காரி என்பதன் பொருள் காக்கை	RWE_M	0
காறி என்பதன் பொருள் வயிரவன்	காரி என்பதன் பொருள் வயிரவன்	RWE_M	0
காறி என்பதன் பொருள் ஐயனார்	காரி என்பதன் பொருள் ஐயனார்	RWE_M	0
காறி என்பதன் பொருள் ஒரு நதி	காரி என்பதன் பொருள் ஒரு நதி	RWE_M	0
காறி என்பதன் பொருள் சனி	காரி என்பதன் பொருள் சனி	RWE_M	0
காறி என்பதன் பொருள் விஷம்	காரி என்பதன் பொருள் விஷம்	RWE_M	0
காறி என்பதன் பொருள் ஒரு வள்ளல்	காரி என்பதன் பொருள் ஒரு வள்ளல்	RWE_M	0
காறி என்பதன் பொருள் வாசுதேவன்	காரி என்பதன் பொருள் வாசுதேவன்	RWE_M	0
காரி என்பதன் பொருள் காறிஉமிழும் கழிவு	காறி என்பதன் பொருள் காறிஉமிழும் கழிவு	RWE_M	0
காறு என்பதன் பொருள் வண்ணான்	காரு என்பதன் பொருள் வண்ணான்	RWE_M	0
காறு என்பதன் பொருள் தேவதச்சன்	காரு என்பதன் பொருள் தேவதச்சன்	RWE_M	0
காரு என்பதன் பொருள் காறி உமிழ்	காறு என்பதன் பொருள் காறி உமிழ்	RWE_M	0
காரு என்பதன் பொருள் அளவு	காறு என்பதன் பொருள் அளவு	RWE_M	0
காறை என்பதன் பொருள் ஒரு வகை செடி	காரை என்பதன் பொருள் ஒரு வகை செடி	RWE_M	0
காறை என்பதன் பொருள் ஒரு வகை மீன்	காரை என்பதன் பொருள் ஒரு வகை மீன்	RWE_M	0
காறை என்பதன் பொருள் சிமெண்ட் மணல் சேர்ந்த கலவை	காரை என்பதன் பொருள் சிமெண்ட் மணல் சேர்ந்த கலவை	RWE_M	0
காரை என்பதன் பொருள் ஒரு கழுத்தணி	காறை என்பதன் பொருள் ஒரு கழுத்தணி	RWE_M	0
கீறி ஓர் உயிரினம்	கீரி ஓர் உயிரினம்	RWE_M	0
கீரி என்பதன் பொருள் பிளந்து	கீறி என்பதன் பொருள் பிளந்து	RWE_M	0
கீரி என்பதன் பொருள் அரிந்து	கீறி என்பதன் பொருள் அரிந்து	RWE_M	0
குறங்கு என்பதன் பொருள் ஒரு விலங்கு	குரங்கு என்பதன் பொருள் ஒரு விலங்கு	RWE_M	0
குரங்கு என்பதன் பொருள் தொடை	குறங்கு என்பதன் பொருள் தொடை	RWE_M	0
குரங்கு என்பதன் பொருள் கொக்கி	குறங்கு என்பதன் பொருள் கொக்கி	RWE_M	0
குறவர் என்பதன் பொருள் கடவுள்	குரவர் என்பதன் பொருள் கடவுள்	RWE_M	0
குறவர் என்பதன் பொருள் குரு	குரவர் என்பதன் பொருள் குரு	RWE_M	0
குறவர் என்பதன் பொருள் பெரியோர்	குரவர் என்பதன் பொருள் பெரியோர்	RWE_M	0
குறவர் என்பதன் பொருள் அரசர்	குரவர் என்பதன் பொருள் அரசர்	RWE_M	0
குரவர் என்பதன் பொருள் ஒரு ஜாதியினர்	குறவர் என்பதன் பொருள் ஒரு ஜாதியினர்	RWE_M	0
குறவை என்பதன் பொருள் கூத்து வகை	குரவை என்பதன் பொருள் கூத்து வகை	RWE_M	0
குறவை என்பதன் பொருள் ஒலி	குரவை என்பதன் பொருள் ஒலி	RWE_M	0
குறவை என்பதன் பொருள் கடல்	குரவை என்பதன் பொருள் கடல்	RWE_M	0
குறவை என்பதன் பொருள் மகளிர் மகிழ்ச்சி	குரவை என்பதன் பொருள் மகளிர் மகிழ்ச்சி	RWE_M	0
குரவை என்பதன் பொருள் ஒருவகை மீன்	குறவை என்பதன் பொருள் ஒருவகை மீன்	RWE_M	0
குறத்தி என்பதன் பொருள் தலைவி	குரத்தி என்பதன் பொருள் தலைவி	RWE_M	0
குறத்தி என்பதன் பொருள் குருவின் மனைவி	குரத்தி என்பதன் பொருள் குருவின் மனைவி	RWE_M	0
குரத்தி என்பதன் பொருள் குறத்தி ஜாதிப் பெண்	குறத்தி என்பதன் பொருள் குறத்தி ஜாதிப் பெண்	RWE_M	0
குறுகு என்பதன் பொருள் பறவை	குருகு என்பதன் பொருள் பறவை	RWE_M	0
குறுகு என்பதன் பொருள் குட்டி	குருகு என்பதன் பொருள் குட்டி	RWE_M	0
குறுகு என்பதன் பொருள் கொக்கு	குருகு என்பதன் பொருள் கொக்கு	RWE_M	0
குறுகு என்பதன் பொருள் உலைத்துருத்தி	குருகு என்பதன் பொருள் உலைத்துருத்தி	RWE_M	0
குறுகு என்பதன் பொருள் உலைமூக்கு	குருகு என்பதன் பொருள் உலைமூக்கு	RWE_M	0
குறுகு என்பதன் பொருள் குருக்கத்தி	குருகு என்பதன் பொருள் குருக்கத்தி	RWE_M	0
குறுகு என்பதன் பொருள் நாரை	குருகு என்பதன் பொருள் நாரை	RWE_M	0
குறுகு என்பதன் பொருள் கோழி	குருகு என்பதன் பொருள் கோழி	RWE_M	0
குறுகு என்பதன் பொருள் கைவளை	குருகு என்பதன் பொருள் கைவளை	RWE_M	0
குருகு என்பதன் பொருள் அண்மைப்படுத்து	குறுகு என்பதன் பொருள் அண்மைப்படுத்து	RWE_M	0
குறுகினம் என்பதன் பொருள் பறவை இனம்	குருகினம் என்பதன் பொருள் பறவை இனம்	RWE_M	0
குருகினம் என்பதன் பொருள் நெருங்கினோம்	குறுகினம் என்பதன் பொருள் நெருங்கினோம்	RWE_M	0
குறை என்பதன் பொருள் சத்தம்	குரை என்பதன் பொருள் சத்தம்	RWE_M	0
குறை என்பதன் பொருள் ஒலி	குரை என்பதன் பொருள் ஒலி	RWE_M	0
குறை என்பதன் பொருள் குதிரை	குரை என்பதன் பொருள் குதிரை	RWE_M	0
குறை என்பதன் பொருள் பெருமை	குரை என்பதன் பொருள் பெருமை	RWE_M	0
குறை என்பதன் பொருள் ஓசை	குரை என்பதன் பொருள் ஓசை	RWE_M	0
குரை என்பதன் பொருள் குற்றம்	குறை என்பதன் பொருள் குற்றம்	RWE_M	0
குரை என்பதன் பொருள் காரியம்	குறை என்பதன் பொருள் காரியம்	RWE_M	0
குரை என்பதன் பொருள் கடன்	குறை என்பதன் பொருள் கடன்	RWE_M	0
குரை என்பதன் பொருள் வேண்டுகோள்	குறை என்பதன் பொருள் வேண்டுகோள்	RWE_M	0
குரை என்பதன் பொருள் வறுமை	குறை என்பதன் பொருள் வறுமை	RWE_M	0
குறு என்பதன் பொருள் ஆசிரியர்	குரு என்பதன் பொருள் ஆசிரியர்	RWE_M	0
குறு என்பதன் பொருள் மேன்மை	குரு என்பதன் பொருள் மேன்மை	RWE_M	0
குறு என்பதன் பொருள் கனம்	குரு என்பதன் பொருள் கனம்	RWE_M	0
குறு என்பதன் பொருள் வியாழன்	குரு என்பதன் பொருள் வியாழன்	RWE_M	0
குறு என்பதன் பொருள் நிறம்	குரு என்பதன் பொருள் நிறம்	RWE_M	0
குறு என்பதன் பொருள் தந்தை	குரு என்பதன் பொருள் தந்தை	RWE_M	0
குறு என்பதன் பொருள் இரசம்	குரு என்பதன் பொருள் இரசம்	RWE_M	0
குரு என்பதன் பொருள் குறுகு	குறு என்பதன் பொருள் குறுகு	RWE_M	0
கூறல் என்பதன் பொருள் ஒரு மீன்	கூரல் என்பதன் பொருள் ஒரு மீன்	RWE_M	0
கூறல் என்பதன் பொருள் பறவை இறகு	கூரல் என்பதன் பொருள் பறவை இறகு	RWE_M	0
கூரல் என்பதன் பொருள் சொல்லுதல்	கூறல் என்பதன் பொருள் சொல்லுதல்	RWE_M	0
கூரல் என்பதன் பொருள் விற்றல்	கூறல் என்பதன் பொருள் விற்றல்	RWE_M	0
கூறை என்பதன் பொருள் சிறிய ஓலை வீடு	கூரை என்பதன் பொருள் சிறிய ஓலை வீடு	RWE_M	0
கூறை என்பதன் பொருள் வீட்டின் மேற்கூரை	கூரை என்பதன் பொருள் வீட்டின் மேற்கூரை	RWE_M	0
கூறை என்பதன் பொருள் சிற்றில்	கூரை என்பதன் பொருள் சிற்றில்	RWE_M	0
கூரை என்பதன் பொருள் புது ஆடை	கூறை என்பதன் பொருள் புது ஆடை	RWE_M	0
கூரை என்பதன் பொருள் சீலை	கூறை என்பதன் பொருள் சீலை	RWE_M	0
கூறிய என்பதன் பொருள் கூர்மையான	கூரிய என்பதன் பொருள் கூர்மையான	RWE_M	0
கூரிய என்பதன் பொருள் சொன்ன	கூறிய என்பதன் பொருள் சொன்ன	RWE_M	0
கூற என்பதன் பொருள் குளிர்ச்சி மிக	கூர என்பதன் பொருள் குளிர்ச்சி மிக	RWE_M	0
கூர என்பதன் பொருள் சொல்ல	கூற என்பதன் பொருள் சொல்ல	RWE_M	0
கூர என்பதன் பொருள் வேண்டல்	கூற என்பதன் பொருள் வேண்டல்	RWE_M	0
கோறல் என்பதன் பொருள் கூறுதல்	கோரல் என்பதன் பொருள் கூறுதல்	RWE_M	0
கோரல் என்பதன் பொருள் கொல்லல்	கோறல் என்பதன் பொருள் கொல்லல்	RWE_M	0
கோறை என்பதன் பொருள் புல்வகை	கோரை என்பதன் பொருள் புல்வகை	RWE_M	0
கோரை என்பதன் பொருள் குவளை	கோறை என்பதன் பொருள் குவளை	RWE_M	0
கோரை என்பதன் பொருள் பொந்து	கோறை என்பதன் பொருள் பொந்து	RWE_M	0
கோறல் என்பதன் பொருள் சேர்தல்	கோரல் என்பதன் பொருள் சேர்தல்	RWE_M	0
கோறல் என்பதன் பொருள் குளிர் காற்று	கோரல் என்பதன் பொருள் குளிர் காற்று	RWE_M	0
கோறல் என்பதன் பொருள் மலைப்பக்கம்	கோரல் என்பதன் பொருள் மலைப்பக்கம்	RWE_M	0
கோரல் என்பதன் பொருள் குளிர் காற்று	கோறல் என்பதன் பொருள் குளிர் காற்று	RWE_M	0
கோரல் என்பதன் பொருள் மழை	கோறல் என்பதன் பொருள் மழை	RWE_M	0
சிறை என்பதன் பொருள் சிரைத்தல்	சிரை என்பதன் பொருள் சிரைத்தல்	RWE_M	0
சிறை என்பதன் பொருள் முடிநீக்கல்	சிரை என்பதன் பொருள் முடிநீக்கல்	RWE_M	0
சிரை என்பதன் பொருள் சிறைச்சாலை	சிறை என்பதன் பொருள் சிறைச்சாலை	RWE_M	0
சிரை என்பதன் பொருள் மதில்	சிறை என்பதன் பொருள் மதில்	RWE_M	0
சிரை என்பதன் பொருள் காவல்	சிறை என்பதன் பொருள் காவல்	RWE_M	0
சிரை என்பதன் பொருள் பக்கம்	சிறை என்பதன் பொருள் பக்கம்	RWE_M	0
சிரை என்பதன் பொருள் நீர்க்கரை	சிறை என்பதன் பொருள் நீர்க்கரை	RWE_M	0
சிரை என்பதன் பொருள் இறகு	சிறை என்பதன் பொருள் இறகு	RWE_M	0
சிரை என்பதன் பொருள் அடிமை	சிறை என்பதன் பொருள் அடிமை	RWE_M	0
சிரை என்பதன் பொருள் அறை	சிறை என்பதன் பொருள் அறை	RWE_M	0
சிரை என்பதன் பொருள் அணை	சிறை என்பதன் பொருள் அணை	RWE_M	0
சீறிய என்பதன் பொருள் சினந்த	சீரிய என்பதன் பொருள் சினந்த	RWE_M	0
சீறிய என்பதன் பொருள்​​ சிறந்த,​	சீரிய என்பதன் பொருள்​​ சிறந்த,​	RWE_M	0
சீறிய என்பதன் பொருள் சீராய்​	சீரிய என்பதன் பொருள் சீராய்​	RWE_M	0
சீரிய என்பதன் பொருள் சினந்த	சீறிய என்பதன் பொருள் சினந்த	RWE_M	0
சுறா​​ என்பதன் பொருள் கள்​	சுரா​ என்பதன் பொருள் கள்​	RWE_M	0
சுரா​ என்பதன் பொருள் சுறா மீன்	சுறா​ என்பதன் பொருள் சுறா மீன்	RWE_M	0
சூறல்​ என்பதன் பொருள் மூங்​கில்,​​ பிரம்பு​	சூரல்​ என்பதன் பொருள் மூங்​கில்,​​ பிரம்பு​	RWE_M	0
சூரல்​ என்பதன் பொருள்​ தோண்​டல்	சூறல்​ என்பதன் பொருள்​ தோண்​டல்	RWE_M	0
சுறுக்கு​ என்பதன் பொருள்​ வலை	சுருக்கு​ என்பதன் பொருள்​ வலை	RWE_M	0
சுறுக்கு​ என்பதன் பொருள்​​ சுருக்​கம்	சுருக்கு​ என்பதன் பொருள்​​ சுருக்​கம்	RWE_M	0
சுறுக்கு​ என்பதன் பொருள்​​ கட்டு	சுருக்கு​ என்பதன் பொருள்​​ கட்டு	RWE_M	0
சுறுக்கு​ என்பதன் பொருள்​​ பூமாலை	சுருக்கு​ என்பதன் பொருள்​​ பூமாலை	RWE_M	0
சுறுக்கு​ என்பதன் பொருள் வகை	சுருக்கு​ என்பதன் பொருள் வகை	RWE_M	0
சுறுக்கு​ என்பதன் பொருள்​​ குறைவு	சுருக்கு​ என்பதன் பொருள்​​ குறைவு	RWE_M	0
சுறுக்கு​ என்பதன் பொருள் நெய்த்​து​டுப்பு​	சுருக்கு​ என்பதன் பொருள் நெய்த்​து​டுப்பு​	RWE_M	0
சுருக்கு​ என்பதன் பொருள் விரைவு	சுறுக்கு​ என்பதன் பொருள் விரைவு	RWE_M	0
செறு​ என்பதன் பொருள் போர்	செரு​ என்பதன் பொருள் போர்	RWE_M	0
செறு​​ என்பதன் பொருள் ஊடல்	செரு​ என்பதன் பொருள் ஊடல்	RWE_M	0
செரு​​ என்பதன் பொருள்​ வயல்	செறு​ என்பதன் பொருள்​ வயல்	RWE_M	0
செரு​​ என்பதன் பொருள்​​ பாத்தி	செறு​ என்பதன் பொருள்​​ பாத்தி	RWE_M	0
செரு​​ என்பதன் பொருள்​​ குளம்	செறு​ என்பதன் பொருள்​​ குளம்	RWE_M	0
செறு​நர்​​ என்பதன் பொருள் பகை​வர்	செரு​நர்​ என்பதன் பொருள் பகை​வர்	RWE_M	0
செறு​நர்​​ என்பதன் பொருள்​​ படை​வீ​ரர்​	செரு​நர்​ என்பதன் பொருள்​​ படை​வீ​ரர்​	RWE_M	0
செரு​நர்​ என்பதன் பொருள்​ பகை​வர்	செறு​நர்​ என்பதன் பொருள்​ பகை​வர்	RWE_M	0
சொறி​ என்பதன் பொருள்​ தினவு	சொரி​ என்பதன் பொருள்​ தினவு	RWE_M	0
சொறி​ என்பதன் பொருள் அரிப்பு	சொரி​ என்பதன் பொருள் அரிப்பு	RWE_M	0
சொறி என்பதன் பொருள் பொழி	சொரி​ என்பதன் பொருள் பொழி	RWE_M	0
சொரி என்பதன் பொருள்​ சிரங்கு	சொறி என்பதன் பொருள்​ சிரங்கு	RWE_M	0
சொரி என்பதன் பொருள் சொறி​தல்	சொறி என்பதன் பொருள் சொறி​தல்	RWE_M	0
தறித்​தல்​ என்பதன் பொருள் அணி​தல்	தரித்​தல்​ என்பதன் பொருள் அணி​தல்	RWE_M	0
தறித்​தல்​ என்பதன் பொருள்​​ பொறுத்​தல்	தரித்​தல்​ என்பதன் பொருள்​​ பொறுத்​தல்	RWE_M	0
தறித்​தல்​ என்பதன் பொருள் தங்​கல்	தரித்​தல்​ என்பதன் பொருள் தங்​கல்	RWE_M	0
தறித்​தல்​ என்பதன் பொருள் தாம​தித்​தல்	தரித்​தல்​ என்பதன் பொருள் தாம​தித்​தல்	RWE_M	0
தறித்​தல் என்பதன் பொருள் தாங்​கு​தல்​	தரித்​தல்​ என்பதன் பொருள் தாங்​கு​தல்​	RWE_M	0
தரித்​தல் என்பதன் பொருள் வெட்​டு​தல்	தறித்​தல் என்பதன் பொருள் வெட்​டு​தல்	RWE_M	0
தறி​ என்பதன் பொருள் அணி	தரி​ என்பதன் பொருள் அணி	RWE_M	0
தறி​ என்பதன் பொருள் அணிந்​து ​கொள்​	தரி​ என்பதன் பொருள் அணிந்​து ​கொள்​	RWE_M	0
தரி என்பதன் பொருள் தூண்	தறி என்பதன் பொருள் தூண்	RWE_M	0
தரி என்பதன் பொருள் ஆப்பு	தறி என்பதன் பொருள் ஆப்பு	RWE_M	0
தரி என்பதன் பொருள் நெசவு இயந்​தி​ரம்	தறி என்பதன் பொருள் நெசவு இயந்​தி​ரம்	RWE_M	0
தரி என்பதன் பொருள் முளைக்​கோல்	தறி என்பதன் பொருள் முளைக்​கோல்	RWE_M	0
தறு​தல் என்பதன் பொருள்​ கொடுத்​தல்​	தரு​தல் என்பதன் பொருள்​ கொடுத்​தல்​	RWE_M	0
தரு​தல்​ என்பதன் பொருள் இறு​கக்​ கட்​டு​தல்	தறு​தல்​ என்பதன் பொருள் இறு​கக்​ கட்​டு​தல்	RWE_M	0
தாறு​​ என்பதன் பொருள் மரம்	தாரு​ என்பதன் பொருள் மரம்	RWE_M	0
தாறு​​ என்பதன் பொருள் தேவ​தாரு	தாரு​ என்பதன் பொருள் தேவ​தாரு	RWE_M	0
தாறு​​ என்பதன் பொருள் பித்​தளை	தாரு​ என்பதன் பொருள் பித்​தளை	RWE_M	0
தாரு​ என்பதன் பொருள்​ குலை	தாறு​ என்பதன் பொருள்​ குலை	RWE_M	0
தாரு​ என்பதன் பொருள்​​ அங்​கு​சம்	தாறு​ என்பதன் பொருள்​​ அங்​கு​சம்	RWE_M	0
தாரு​ என்பதன் பொருள்​​ முள்	தாறு​ என்பதன் பொருள்​​ முள்	RWE_M	0
தாரு​ என்பதன் பொருள் இரும்பு	தாறு​ என்பதன் பொருள் இரும்பு	RWE_M	0
தாரு​ என்பதன் பொருள் முள்​கோல்	தாறு​ என்பதன் பொருள் முள்​கோல்	RWE_M	0
திறம்​ என்பதன் பொருள் மலை	திரம்​ என்பதன் பொருள் மலை	RWE_M	0
திறம்​ என்பதன் பொருள்​​ உறுதி	திரம்​ என்பதன் பொருள்​​ உறுதி	RWE_M	0
திறம்​ என்பதன் பொருள்​​ நிலை	திரம்​ என்பதன் பொருள்​​ நிலை	RWE_M	0
திறம்​ என்பதன் பொருள் பூமி​	திரம்​ என்பதன் பொருள் பூமி​	RWE_M	0
திரம்​ என்பதன் பொருள் உறுதி	திறம்​ என்பதன் பொருள் உறுதி	RWE_M	0
திரம்​ என்பதன் பொருள் நரம்​புள்ள வீணை	திறம்​ என்பதன் பொருள் நரம்​புள்ள வீணை	RWE_M	0
திரம்​ என்பதன் பொருள் கூறு​பாடு	திறம்​ என்பதன் பொருள் கூறு​பாடு	RWE_M	0
திரம்​ என்பதன் பொருள்​​ சுற்​றம்	திறம்​ என்பதன் பொருள்​​ சுற்​றம்	RWE_M	0
திரம்​ என்பதன் பொருள்​​ குலம்	திறம்​ என்பதன் பொருள்​​ குலம்	RWE_M	0
திரம்​ என்பதன் பொருள்​​ பக்​கம்	திறம்​ என்பதன் பொருள்​​ பக்​கம்	RWE_M	0
திரம் என்பதன் பொருள் வல்​லமை	திறம்​ என்பதன் பொருள் வல்​லமை	RWE_M	0
திரம்​ என்பதன் பொருள் ஒழுக்​கம்	திறம்​ என்பதன் பொருள் ஒழுக்​கம்	RWE_M	0
திரம்​ என்பதன் பொருள்​​ மேன்மை	திறம்​ என்பதன் பொருள்​​ மேன்மை	RWE_M	0
திரம்​ என்பதன் பொருள் வர​லாறு	திறம்​ என்பதன் பொருள் வர​லாறு	RWE_M	0
திரம்​ என்பதன் பொருள்​​ கார​ணம்	திறம்​ என்பதன் பொருள்​​ கார​ணம்	RWE_M	0
திறை​ என்பதன் பொருள் அலை	திரை​ என்பதன் பொருள் அலை	RWE_M	0
திறை​ என்பதன் பொருள்​​ கடல்	திரை​ என்பதன் பொருள்​​ கடல்	RWE_M	0
திறை​ என்பதன் பொருள்​​ திரைச் ​சீலை	திரை​ என்பதன் பொருள்​​ திரைச் ​சீலை	RWE_M	0
திரை​ என்பதன் பொருள்​ கப்​பம்	திறை​ என்பதன் பொருள்​ கப்​பம்	RWE_M	0
துறவு​​ என்பதன் பொருள்​ கிணறு​	துரவு​ என்பதன் பொருள்​ கிணறு​	RWE_M	0
துரவு​ என்பதன் பொருள் துறத்​தல்	துறவு​ என்பதன் பொருள் துறத்​தல்	RWE_M	0
துரவு​ என்பதன் பொருள்​​ துற​வ​றம்	துறவு​ என்பதன் பொருள்​​ துற​வ​றம்	RWE_M	0
துறை​ என்பதன் பொருள் பெரி​யோன்	துரை​ என்பதன் பொருள் பெரி​யோன்	RWE_M	0
துறை​ என்பதன் பொருள்​​ தலை​வன்	துரை​ என்பதன் பொருள்​​ தலை​வன்	RWE_M	0
துரை​ என்பதன் பொருள் நீர்த்​துறை	துறை​ என்பதன் பொருள் நீர்த்​துறை	RWE_M	0
துரை​ என்பதன் பொருள் வழி	துறை​ என்பதன் பொருள் வழி	RWE_M	0
துரை என்பதன் பொருள் இடம்	துறை​ என்பதன் பொருள் இடம்	RWE_M	0
துரை என்பதன் பொருள்​​ நூல்	துறை​ என்பதன் பொருள்​​ நூல்	RWE_M	0
துரை​ என்பதன் பொருள்​​ கடற்​கரை	துறை​ என்பதன் பொருள்​​ கடற்​கரை	RWE_M	0
துரை​ என்பதன் பொருள் உபா​யம்	துறை​ என்பதன் பொருள் உபா​யம்	RWE_M	0
துரை​ என்பதன் பொருள் பாவி​னம்	துறை​ என்பதன் பொருள் பாவி​னம்	RWE_M	0
துறு​ என்பதன் பொருள்​ களிம்பு	துரு​ என்பதன் பொருள்​ களிம்பு	RWE_M	0
துரு​ என்பதன் பொருள் கூட்​டம்	துறு​ என்பதன் பொருள் கூட்​டம்	RWE_M	0
துரு என்பதன் பொருள் நெருக்​கம்	துறு​ என்பதன் பொருள் நெருக்​கம்	RWE_M	0
தூறல்​ என்பதன் பொருள்​ தூரு​தல்	தூரல்​ என்பதன் பொருள்​ தூரு​தல்	RWE_M	0
தூறல் என்பதன் பொருள்​​​ வருத்​தம்	தூரல்​ என்பதன் பொருள்​​​ வருத்​தம்	RWE_M	0
தூரல்​ என்பதன் பொருள் மழைத்​துளி	தூறல்​ என்பதன் பொருள் மழைத்​துளி	RWE_M	0
தூரல்​ என்பதன் பொருள் பழி சொல்​லு​தல்	தூறல்​ என்பதன் பொருள் பழி சொல்​லு​தல்	RWE_M	0
தூறன் என்பதன் பொருள் குலத்​தின் பெயர்	தூரன்​ என்பதன் பொருள் குலத்​தின் பெயர்	RWE_M	0
தூரன்​​ என்பதன் பொருள்​ மூர்க்​கன்	தூறன்​ என்பதன் பொருள்​ மூர்க்​கன்	RWE_M	0
துறு​ என்பதன் பொருள் வீதி	துரு​ என்பதன் பொருள் வீதி	RWE_M	0
துரு​ என்பதன் பொருள்​ உண்	துறு​ என்பதன் பொருள்​ உண்	RWE_M	0
தேறார்​ என்பதன் பொருள்​ கல்​லா​த​வர்	தேரார்​ என்பதன் பொருள்​ கல்​லா​த​வர்	RWE_M	0
தேறார்​ என்பதன் பொருள்​​ கீழ்​மக்​கள்	தேரார்​ என்பதன் பொருள்​​ கீழ்​மக்​கள்	RWE_M	0
தேறார்​ என்பதன் பொருள் பகை​வர்​	தேரார்​ என்பதன் பொருள் பகை​வர்​	RWE_M	0
தேரார்​ என்பதன் பொருள் அறி​வி​லார்	தேறார்​ என்பதன் பொருள் அறி​வி​லார்	RWE_M	0
தேரார்​ என்பதன் பொருள் பகை​வர்	தேறார்​ என்பதன் பொருள் பகை​வர்	RWE_M	0
தேறி என்பதன் பொருள் மணல் திட்டை	தேரி என்பதன் பொருள் மணல் திட்டை	RWE_M	0
தேறி என்பதன் பொருள் மணல் குன்று	தேரி என்பதன் பொருள் மணல் குன்று	RWE_M	0
தேரி என்பதன் பொருள் தேர்ச்சி பெற்று	தேறி என்பதன் பொருள் தேர்ச்சி பெற்று	RWE_M	0
தேரி என்பதன் பொருள் தெளிந்து	தேறி என்பதன் பொருள் தெளிந்து	RWE_M	0
நறை என்பதன் பொருள் நரைமுடி	நரை என்பதன் பொருள் நரைமுடி	RWE_M	0
நறை என்பதன் பொருள் வெண் மயிர்	நரை என்பதன் பொருள் வெண் மயிர்	RWE_M	0
நறை என்பதன் பொருள் மூப்பு	நரை என்பதன் பொருள் மூப்பு	RWE_M	0
நறை என்பதன் பொருள் எருது	நரை என்பதன் பொருள் எருது	RWE_M	0
நறை என்பதன் பொருள் கவரிமா	நரை என்பதன் பொருள் கவரிமா	RWE_M	0
நறை என்பதன் பொருள் மரச்சொத்தை	நரை என்பதன் பொருள் மரச்சொத்தை	RWE_M	0
நறை என்பதன் பொருள் பெருமை	நரை என்பதன் பொருள் பெருமை	RWE_M	0
நரை என்பதன் பொருள் தேன்	நறை என்பதன் பொருள் தேன்	RWE_M	0
நரை என்பதன் பொருள் சாதிக்காய்	நறை என்பதன் பொருள் சாதிக்காய்	RWE_M	0
நரை என்பதன் பொருள் கள்	நறை என்பதன் பொருள் கள்	RWE_M	0
நரை என்பதன் பொருள் வாசனை	நறை என்பதன் பொருள் வாசனை	RWE_M	0
நரை என்பதன் பொருள் நறும்புகை	நறை என்பதன் பொருள் நறும்புகை	RWE_M	0
நரை என்பதன் பொருள் பச்சிலைக் கொடி	நறை என்பதன் பொருள் பச்சிலைக் கொடி	RWE_M	0
நரை என்பதன் பொருள் குற்றம்	நறை என்பதன் பொருள் குற்றம்	RWE_M	0
நாறி என்பதன் பொருள் பெண்	நாரி என்பதன் பொருள் பெண்	RWE_M	0
நாறி என்பதன் பொருள் பார்வதி	நாரி என்பதன் பொருள் பார்வதி	RWE_M	0
நாறி என்பதன் பொருள் வாசனை	நாரி என்பதன் பொருள் வாசனை	RWE_M	0
நாறி என்பதன் பொருள் கள்	நாரி என்பதன் பொருள் கள்	RWE_M	0
நாறி என்பதன் பொருள் சேனை	நாரி என்பதன் பொருள் சேனை	RWE_M	0
நாறி என்பதன் பொருள் பன்னாடை	நாரி என்பதன் பொருள் பன்னாடை	RWE_M	0
நாறி என்பதன் பொருள் தேன்	நாரி என்பதன் பொருள் தேன்	RWE_M	0
நாரி என்பதன் பொருள் கற்றாழை	நாறி என்பதன் பொருள் கற்றாழை	RWE_M	0
நிறுத்தம் என்பதன் பொருள் கூத்து	நிருத்தம் என்பதன் பொருள் கூத்து	RWE_M	0
நிறுத்தம் என்பதன் பொருள் நடனம்	நிருத்தம் என்பதன் பொருள் நடனம்	RWE_M	0
நிறுத்தம் என்பதன் பொருள் பதம் பிரித்துப் பொருள் கூறும் நூல்	நிருத்தம் என்பதன் பொருள் பதம் பிரித்துப் பொருள் கூறும் நூல்	RWE_M	0
நிறுத்தம் என்பதன் பொருள் பற்றின்மை	நிருத்தம் என்பதன் பொருள் பற்றின்மை	RWE_M	0
நிருத்தம் என்பதன் பொருள் நிறுத்தும் இடம்	நிறுத்தம் என்பதன் பொருள் நிறுத்தும் இடம்	RWE_M	0
நிறை என்பதன் பொருள் பசு	நிரை என்பதன் பொருள் பசு	RWE_M	0
நிறை என்பதன் பொருள் ஒழுங்கு	நிரை என்பதன் பொருள் ஒழுங்கு	RWE_M	0
நிறை என்பதன் பொருள் வரிசை	நிரை என்பதன் பொருள் வரிசை	RWE_M	0
நிரை என்பதன் பொருள் கற்பு	நிறை என்பதன் பொருள் கற்பு	RWE_M	0
நிரை என்பதன் பொருள் அளவு	நிறை என்பதன் பொருள் அளவு	RWE_M	0
நிரை என்பதன் பொருள் அழிவின்மை	நிறை என்பதன் பொருள் அழிவின்மை	RWE_M	0
நிரை என்பதன் பொருள் நீதி	நிறை என்பதன் பொருள் நீதி	RWE_M	0
நிரை என்பதன் பொருள் வரையறை	நிறை என்பதன் பொருள் வரையறை	RWE_M	0
நிரை என்பதன் பொருள் திண்மை	நிறை என்பதன் பொருள் திண்மை	RWE_M	0
நிரை என்பதன் பொருள் நிரப்பு	நிறை என்பதன் பொருள் நிரப்பு	RWE_M	0
நூறல் என்பதன் பொருள் அவிதல்	நூரல் என்பதன் பொருள் அவிதல்	RWE_M	0
நூறல் என்பதன் பொருள் பதங்கெடுதல்	நூரல் என்பதன் பொருள் பதங்கெடுதல்	RWE_M	0
நூரல் என்பதன் பொருள் அவித்தல்	நூறல் என்பதன் பொருள் அவித்தல்	RWE_M	0
நேறி என்பதன் பொருள் அமுக்கு	நேரி என்பதன் பொருள் அமுக்கு	RWE_M	0
நேறி என்பதன் பொருள் நசுக்கு	நேரி என்பதன் பொருள் நசுக்கு	RWE_M	0
நேறி என்பதன் பொருள் அழுத்து	நேரி என்பதன் பொருள் அழுத்து	RWE_M	0
நேரி என்பதன் பொருள் வழி	நேறி என்பதன் பொருள் வழி	RWE_M	0
நேரி என்பதன் பொருள் கோயில்	நேறி என்பதன் பொருள் கோயில்	RWE_M	0
நேரி என்பதன் பொருள் கற்பு	நேறி என்பதன் பொருள் கற்பு	RWE_M	0
பறட்டை என்பதன் பொருள் பரட்டைத்தலை	பரட்டை என்பதன் பொருள் பரட்டைத்தலை	RWE_M	0
பரட்டை என்பதன் பொருள் செழிப்பற்றது	பறட்டை என்பதன் பொருள் செழிப்பற்றது	RWE_M	0
பறதி என்பதன் பொருள் கூத்தாடுபவன்	பரதி என்பதன் பொருள் கூத்தாடுபவன்	RWE_M	0
பரதி என்பதன் பொருள் அவசரம்	பறதி என்பதன் பொருள் அவசரம்	RWE_M	0
பரதி என்பதன் பொருள் பறத்தல்	பறதி என்பதன் பொருள் பறத்தல்	RWE_M	0
பறத்தல் என்பதன் பொருள் அலமறுதல்	பரத்தல் என்பதன் பொருள் அலமறுதல்	RWE_M	0
பறத்தல் என்பதன் பொருள் மிகுதல்	பரத்தல் என்பதன் பொருள் மிகுதல்	RWE_M	0
பரத்தல் என்பதன் பொருள் பறந்து செல்லல்	பறத்தல் என்பதன் பொருள் பறந்து செல்லல்	RWE_M	0
பறம்பு என்பதன் பொருள் வயலை சமப்படுத்தும் பலகை	பரம்பு என்பதன் பொருள் வயலை சமப்படுத்தும் பலகை	RWE_M	0
பரம்பு என்பதன் பொருள் பாரியின் மலை	பறம்பு என்பதன் பொருள் பாரியின் மலை	RWE_M	0
பறல் என்பதன் பொருள் விதை	பரல் என்பதன் பொருள் விதை	RWE_M	0
பறல் என்பதன் பொருள் பருக்கைக்கல்	பரல் என்பதன் பொருள் பருக்கைக்கல்	RWE_M	0
பரல் என்பதன் பொருள் பறவை	பறல் என்பதன் பொருள் பறவை	RWE_M	0
பறவை என்பதன் பொருள் கடல்	பரவை என்பதன் பொருள் கடல்	RWE_M	0
பறவை என்பதன் பொருள் ஆடல்	பரவை என்பதன் பொருள் ஆடல்	RWE_M	0
பறவை என்பதன் பொருள் பரப்பு	பரவை என்பதன் பொருள் பரப்பு	RWE_M	0
பரவை என்பதன் பொருள் பறப்பவை	பறவை என்பதன் பொருள் பறப்பவை	RWE_M	0
பரவை என்பதன் பொருள் ஒரு நோய்	பறவை என்பதன் பொருள் ஒரு நோய்	RWE_M	0
பறி என்பதன் பொருள் குதிரை	பரி என்பதன் பொருள் குதிரை	RWE_M	0
பறி என்பதன் பொருள் பெருமை	பரி என்பதன் பொருள் பெருமை	RWE_M	0
பறி என்பதன் பொருள் விரைவு	பரி என்பதன் பொருள் விரைவு	RWE_M	0
பறி என்பதன் பொருள் செலவு	பரி என்பதன் பொருள் செலவு	RWE_M	0
பறி என்பதன் பொருள் சுமை	பரி என்பதன் பொருள் சுமை	RWE_M	0
பறி என்பதன் பொருள் மிகுதி	பரி என்பதன் பொருள் மிகுதி	RWE_M	0
பரி என்பதன் பொருள் பறித்தல்	பறி என்பதன் பொருள் பறித்தல்	RWE_M	0
பரி என்பதன் பொருள் கொள்ளை	பறி என்பதன் பொருள் கொள்ளை	RWE_M	0
பரி என்பதன் பொருள் பொன்	பறி என்பதன் பொருள் பொன்	RWE_M	0
பரி என்பதன் பொருள் வலை	பறி என்பதன் பொருள் வலை	RWE_M	0
பரி என்பதன் பொருள் உடம்பு	பறி என்பதன் பொருள் உடம்பு	RWE_M	0
பரி என்பதன் பொருள் ஓலைப்பாய்	பறி என்பதன் பொருள் ஓலைப்பாய்	RWE_M	0
பறித்தல் என்பதன் பொருள் காத்தல்	பரித்தல் என்பதன் பொருள் காத்தல்	RWE_M	0
பறித்தல் என்பதன் பொருள் ஓடுதல்	பரித்தல் என்பதன் பொருள் ஓடுதல்	RWE_M	0
பறித்தல் என்பதன் பொருள் தாங்குதல்	பரித்தல் என்பதன் பொருள் தாங்குதல்	RWE_M	0
பறித்தல் என்பதன் பொருள் சுமத்தல்	பரித்தல் என்பதன் பொருள் சுமத்தல்	RWE_M	0
பறித்தல் என்பதன் பொருள் சூழ்தல்	பரித்தல் என்பதன் பொருள் சூழ்தல்	RWE_M	0
பறித்தல் என்பதன் பொருள் தரித்தல்	பரித்தல் என்பதன் பொருள் தரித்தல்	RWE_M	0
பரித்தல் என்பதன் பொருள் பிடுங்குதல்	பறித்தல் என்பதன் பொருள் பிடுங்குதல்	RWE_M	0
பறிவு என்பதன் பொருள் அன்பு	பரிவு என்பதன் பொருள் அன்பு	RWE_M	0
பறிவு என்பதன் பொருள் துன்பம்	பரிவு என்பதன் பொருள் துன்பம்	RWE_M	0
பறிவு என்பதன் பொருள் இரக்கம்	பரிவு என்பதன் பொருள் இரக்கம்	RWE_M	0
பரிவு என்பதன் பொருள் கழிவு	பறிவு என்பதன் பொருள் கழிவு	RWE_M	0
பரிவு என்பதன் பொருள் அதிர்தல்	பறிவு என்பதன் பொருள் அதிர்தல்	RWE_M	0
பறுகு என்பதன் பொருள் குடி	பருகு என்பதன் பொருள் குடி	RWE_M	0
பறுகு என்பதன் பொருள் அருந்து	பருகு என்பதன் பொருள் அருந்து	RWE_M	0
பருகு என்பதன் பொருள் பறட்டை	பறுகு என்பதன் பொருள் பறட்டை	RWE_M	0
பருகு என்பதன் பொருள் அன்பு	பறுகு என்பதன் பொருள் அன்பு	RWE_M	0
பருகு என்பதன் பொருள் பக்குவம்	பறுகு என்பதன் பொருள் பக்குவம்	RWE_M	0
பறை என்பதன் பொருள் சிவசக்தி	பரை என்பதன் பொருள் சிவசக்தி	RWE_M	0
பரை என்பதன் பொருள் இசைக்கருவி	பறை என்பதன் பொருள் இசைக்கருவி	RWE_M	0
பரை என்பதன் பொருள் இறகு	பறை என்பதன் பொருள் இறகு	RWE_M	0
பரை என்பதன் பொருள் வாத்தியம்	பறை என்பதன் பொருள் வாத்தியம்	RWE_M	0
பரை என்பதன் பொருள் பறவை	பறை என்பதன் பொருள் பறவை	RWE_M	0
பரை என்பதன் பொருள் சொல்	பறை என்பதன் பொருள் சொல்	RWE_M	0
பாறை என்பதன் பொருள் கடப்பாரை	பாரை என்பதன் பொருள் கடப்பாரை	RWE_M	0
பாரை என்பதன் பொருள் கற்பாறை	பாறை என்பதன் பொருள் கற்பாறை	RWE_M	0
பிறை என்பதன் பொருள் உறைமோர்	பிரை என்பதன் பொருள் உறைமோர்	RWE_M	0
பிறை என்பதன் பொருள் பயன்	பிரை என்பதன் பொருள் பயன்	RWE_M	0
பிரை என்பதன் பொருள் பிறைச்சந்திரன்	பிறை என்பதன் பொருள் பிறைச்சந்திரன்	RWE_M	0
பீறு என்பதன் பொருள் புருவம்	பீரு என்பதன் பொருள் புருவம்	RWE_M	0
பீறு என்பதன் பொருள் அச்சமுள்ளோன்	பீரு என்பதன் பொருள் அச்சமுள்ளோன்	RWE_M	0
பீரு என்பதன் பொருள் கிழிவு	பீறு என்பதன் பொருள் கிழிவு	RWE_M	0
புறம் என்பதன் பொருள் மாடம்	புரம் என்பதன் பொருள் மாடம்	RWE_M	0
புறம் என்பதன் பொருள் கோயில்	புரம் என்பதன் பொருள் கோயில்	RWE_M	0
புறம் என்பதன் பொருள் இராஜதானி	புரம் என்பதன் பொருள் இராஜதானி	RWE_M	0
புறம் என்பதன் பொருள் ஊர்	புரம் என்பதன் பொருள் ஊர்	RWE_M	0
புறம் என்பதன் பொருள் முன்	புரம் என்பதன் பொருள் முன்	RWE_M	0
புறம் என்பதன் பொருள் மேல்மாடம்	புரம் என்பதன் பொருள் மேல்மாடம்	RWE_M	0
புறம் என்பதன் பொருள் ஒரு நகரம்	புரம் என்பதன் பொருள் ஒரு நகரம்	RWE_M	0
புரம் என்பதன் பொருள் இடம்	புறம் என்பதன் பொருள் இடம்	RWE_M	0
புரம் என்பதன் பொருள் வரியில்லா நிலம்	புறம் என்பதன் பொருள் வரியில்லா நிலம்	RWE_M	0
புரம் என்பதன் பொருள் பக்கம்	புறம் என்பதன் பொருள் பக்கம்	RWE_M	0
புரம் என்பதன் பொருள் வெளி	புறம் என்பதன் பொருள் வெளி	RWE_M	0
புரம் என்பதன் பொருள் பின்புறம்	புறம் என்பதன் பொருள் பின்புறம்	RWE_M	0
புரம் என்பதன் பொருள் முதுகு	புறம் என்பதன் பொருள் முதுகு	RWE_M	0
பெறுக்கல் என்பதன் பொருள் நிறைத்தல்	பெருக்கல் என்பதன் பொருள் நிறைத்தல்	RWE_M	0
பெறுக்கல் என்பதன் பொருள் மிகுத்தல்	பெருக்கல் என்பதன் பொருள் மிகுத்தல்	RWE_M	0
பெறுக்கல் என்பதன் பொருள் நிரப்புதல்	பெருக்கல் என்பதன் பொருள் நிரப்புதல்	RWE_M	0
பெறுக்கல் என்பதன் பொருள் அதிகப்படுத்தல்	பெருக்கல் என்பதன் பொருள் அதிகப்படுத்தல்	RWE_M	0
பெறுக்கல் என்பதன் பொருள் மிகுவித்தல்	பெருக்கல் என்பதன் பொருள் மிகுவித்தல்	RWE_M	0
பெருக்கல் என்பதன் பொருள் அரிசி	பெறுக்கல் என்பதன் பொருள் அரிசி	RWE_M	0
பெருக்கல் என்பதன் பொருள் மிகுத்தல்	பெறுக்கல் என்பதன் பொருள் மிகுத்தல்	RWE_M	0
பொறி என்பதன் பொருள் நெற்பொரி	பொரி என்பதன் பொருள் நெற்பொரி	RWE_M	0
பொறி என்பதன் பொருள் பொரிதல்	பொரி என்பதன் பொருள் பொரிதல்	RWE_M	0
பொரி என்பதன் பொருள் தீப்பொறி	பொறி என்பதன் பொருள் தீப்பொறி	RWE_M	0
பொரி என்பதன் பொருள் அறிவு	பொறி என்பதன் பொருள் அறிவு	RWE_M	0
பொரி என்பதன் பொருள் எழுந்து	பொறி என்பதன் பொருள் எழுந்து	RWE_M	0
பொரி என்பதன் பொருள் வரிவண்டு	பொறி என்பதன் பொருள் வரிவண்டு	RWE_M	0
பொறித்தல் என்பதன் பொருள் வறுத்தல்	பொரித்தல் என்பதன் பொருள் வறுத்தல்	RWE_M	0
பொறித்தல் என்பதன் பொருள் குஞ்சு பொரித்தல்	பொரித்தல் என்பதன் பொருள் குஞ்சு பொரித்தல்	RWE_M	0
பொரித்தல் என்பதன் பொருள் எழுதுதல்	பொறித்தல் என்பதன் பொருள் எழுதுதல்	RWE_M	0
பொரித்தல் என்பதன் பொருள் தீட்டுதல்	பொறித்தல் என்பதன் பொருள் தீட்டுதல்	RWE_M	0
பொரித்தல் என்பதன் பொருள் பதித்தல்	பொறித்தல் என்பதன் பொருள் பதித்தல்	RWE_M	0
பொரித்தல் என்பதன் பொருள் அடையாளமாக வைத்தல்	பொறித்தல் என்பதன் பொருள் அடையாளமாக வைத்தல்	RWE_M	0
பொறுப்பு என்பதன் பொருள் மலை	பொருப்பு என்பதன் பொருள் மலை	RWE_M	0
பொறுப்பு என்பதன் பொருள் பக்கமலை	பொருப்பு என்பதன் பொருள் பக்கமலை	RWE_M	0
பொருப்பு என்பதன் பொருள் பாரம்	பொறுப்பு என்பதன் பொருள் பாரம்	RWE_M	0
பொருப்பு என்பதன் பொருள் பொறுமை	பொறுப்பு என்பதன் பொருள் பொறுமை	RWE_M	0
பொறு என்பதன் பொருள் போர்	பொரு என்பதன் பொருள் போர்	RWE_M	0
பொரு என்பதன் பொருள் பொறுத்திரு	பொறு என்பதன் பொருள் பொறுத்திரு	RWE_M	0
மறத்தல் என்பதன் பொருள் விறைத்தல்	மரத்தல் என்பதன் பொருள் விறைத்தல்	RWE_M	0
மரத்தல் என்பதன் பொருள் மறதி	மறத்தல் என்பதன் பொருள் மறதி	RWE_M	0
மரத்தல் என்பதன் பொருள் நினைவின்மை	மறத்தல் என்பதன் பொருள் நினைவின்மை	RWE_M	0
மறம் என்பதன் பொருள் தாவர வகை	மரம் என்பதன் பொருள் தாவர வகை	RWE_M	0
மறம் என்பதன் பொருள் மூலிகை	மரம் என்பதன் பொருள் மூலிகை	RWE_M	0
மறம் என்பதன் பொருள் மரக்கலம்	மரம் என்பதன் பொருள் மரக்கலம்	RWE_M	0
மரம் என்பதன் பொருள் வீரம்	மறம் என்பதன் பொருள் வீரம்	RWE_M	0
மரம் என்பதன் பொருள் போர்	மறம் என்பதன் பொருள் போர்	RWE_M	0
மரம் என்பதன் பொருள் சினம்	மறம் என்பதன் பொருள் சினம்	RWE_M	0
மரம் என்பதன் பொருள் மாறுபாடு	மறம் என்பதன் பொருள் மாறுபாடு	RWE_M	0
மரம் என்பதன் பொருள் கொலை	மறம் என்பதன் பொருள் கொலை	RWE_M	0
மரம் என்பதன் பொருள் பாவம்	மறம் என்பதன் பொருள் பாவம்	RWE_M	0
மரம் என்பதன் பொருள் வலி	மறம் என்பதன் பொருள் வலி	RWE_M	0
மரம் என்பதன் பொருள் கொடுமை	மறம் என்பதன் பொருள் கொடுமை	RWE_M	0
மரம் என்பதன் பொருள் மயக்கம்	மறம் என்பதன் பொருள் மயக்கம்	RWE_M	0
மறி என்பதன் பொருள் விலங்குகளின் குட்டி	மரி என்பதன் பொருள் விலங்குகளின் குட்டி	RWE_M	0
மரி என்பதன் பொருள் தடை செய்	மறி என்பதன் பொருள் தடை செய்	RWE_M	0
மறித்தல் என்பதன் பொருள் இறத்தல்	மரித்தல் என்பதன் பொருள் இறத்தல்	RWE_M	0
மறித்தல் என்பதன் பொருள் சாதல்	மரித்தல் என்பதன் பொருள் சாதல்	RWE_M	0
மரித்தல் என்பதன் பொருள் தடுத்தல்	மறித்தல் என்பதன் பொருள் தடுத்தல்	RWE_M	0
மரித்தல் என்பதன் பொருள் திரும்புதல்	மறித்தல் என்பதன் பொருள் திரும்புதல்	RWE_M	0
மரித்தல் என்பதன் பொருள் அழித்தல்	மறித்தல் என்பதன் பொருள் அழித்தல்	RWE_M	0
மறை என்பதன் பொருள் மான்	மரை என்பதன் பொருள் மான்	RWE_M	0
மரை என்பதன் பொருள் வேதம்	மறை என்பதன் பொருள் வேதம்	RWE_M	0
மறு என்பதன் பொருள் மலை	மரு என்பதன் பொருள் மலை	RWE_M	0
மறு என்பதன் பொருள் பாலை நிலம்	மரு என்பதன் பொருள் பாலை நிலம்	RWE_M	0
மறு என்பதன் பொருள் மண விருந்து	மரு என்பதன் பொருள் மண விருந்து	RWE_M	0
மறு என்பதன் பொருள் நீரில்லா இடம்	மரு என்பதன் பொருள் நீரில்லா இடம்	RWE_M	0
மறு என்பதன் பொருள் மருக்கொழுந்து	மரு என்பதன் பொருள் மருக்கொழுந்து	RWE_M	0
மரு என்பதன் பொருள் குற்றம்	மறு என்பதன் பொருள் குற்றம்	RWE_M	0
மரு என்பதன் பொருள் மச்சம்	மறு என்பதன் பொருள் மச்சம்	RWE_M	0
மரு என்பதன் பொருள் எதிர்	மறு என்பதன் பொருள் எதிர்	RWE_M	0
மரு என்பதன் பொருள் வேறு	மறு என்பதன் பொருள் வேறு	RWE_M	0
மரு என்பதன் பொருள் அடையாளம்	மறு என்பதன் பொருள் அடையாளம்	RWE_M	0
மறுப்பு என்பதன் பொருள் கொம்பு	மருப்பு என்பதன் பொருள் கொம்பு	RWE_M	0
மறுப்பு என்பதன் பொருள் யானைத் தந்தம்	மருப்பு என்பதன் பொருள் யானைத் தந்தம்	RWE_M	0
மறுப்பு என்பதன் பொருள் யாழ்த் தண்டு	மருப்பு என்பதன் பொருள் யாழ்த் தண்டு	RWE_M	0
மருப்பு என்பதன் பொருள் எதிர்ப்பு	மறுப்பு என்பதன் பொருள் எதிர்ப்பு	RWE_M	0
மறுகு என்பதன் பொருள் வாசனைத் தாவரம்	மருகு என்பதன் பொருள் வாசனைத் தாவரம்	RWE_M	0
மருகு என்பதன் பொருள் சிறியதெரு	மறுகு என்பதன் பொருள் சிறியதெரு	RWE_M	0
மாறன் என்பதன் பொருள் மன்மதன்	மாரன் என்பதன் பொருள் மன்மதன்	RWE_M	0
மாறன் என்பதன் பொருள் காமன்	மாரன் என்பதன் பொருள் காமன்	RWE_M	0
மாரன் என்பதன் பொருள் பாண்டியன்	மாறன் என்பதன் பொருள் பாண்டியன்	RWE_M	0
மாரன் என்பதன் பொருள் சடகோபாழ்வார்	மாறன் என்பதன் பொருள் சடகோபாழ்வார்	RWE_M	0
முறி என்பதன் பொருள் பாலை நிலம்	முரி என்பதன் பொருள் பாலை நிலம்	RWE_M	0
முறி என்பதன் பொருள் நொய்	முரி என்பதன் பொருள் நொய்	RWE_M	0
முறி என்பதன் பொருள் சிதைவு	முரி என்பதன் பொருள் சிதைவு	RWE_M	0
முரி என்பதன் பொருள் ஒடி	முறி என்பதன் பொருள் ஒடி	RWE_M	0
முரி என்பதன் பொருள் பத்திரம்	முறி என்பதன் பொருள் பத்திரம்	RWE_M	0
முரி என்பதன் பொருள் தளிர்	முறி என்பதன் பொருள் தளிர்	RWE_M	0
முரி என்பதன் பொருள் எழுது	முறி என்பதன் பொருள் எழுது	RWE_M	0
முரி என்பதன் பொருள் துண்டு	முறி என்பதன் பொருள் துண்டு	RWE_M	0
முறுக்குதல் என்பதன் பொருள் அழித்தல்	முருக்குதல் என்பதன் பொருள் அழித்தல்	RWE_M	0
முறுக்குதல் என்பதன் பொருள் உருக்குதல்	முருக்குதல் என்பதன் பொருள் உருக்குதல்	RWE_M	0
முருக்குதல் என்பதன் பொருள் சுழற்றுதல்	முறுக்குதல் என்பதன் பொருள் சுழற்றுதல்	RWE_M	0
முருக்குதல் என்பதன் பொருள் திரித்தல்	முறுக்குதல் என்பதன் பொருள் திரித்தல்	RWE_M	0
வறம் என்பதன் பொருள் இறைவன் கொடுப்பது	வரம் என்பதன் பொருள் இறைவன் கொடுப்பது	RWE_M	0
வறம் என்பதன் பொருள் வேண்டும் பொருள்	வரம் என்பதன் பொருள் வேண்டும் பொருள்	RWE_M	0
வறம் என்பதன் பொருள் தெய்வ ஈகை	வரம் என்பதன் பொருள் தெய்வ ஈகை	RWE_M	0
வறம் என்பதன் பொருள் மேன்மை	வரம் என்பதன் பொருள் மேன்மை	RWE_M	0
வறம் என்பதன் பொருள் விருப்பம்	வரம் என்பதன் பொருள் விருப்பம்	RWE_M	0
வரம் என்பதன் பொருள் வற்றுதல்	வறம் என்பதன் பொருள் வற்றுதல்	RWE_M	0
வரம் என்பதன் பொருள் வறட்சி	வறம் என்பதன் பொருள் வறட்சி	RWE_M	0
வரம் என்பதன் பொருள் பஞ்சம்	வறம் என்பதன் பொருள் பஞ்சம்	RWE_M	0
வரம் என்பதன் பொருள் நீரின்மை	வறம் என்பதன் பொருள் நீரின்மை	RWE_M	0
வரம் என்பதன் பொருள் வறுமை	வறம் என்பதன் பொருள் வறுமை	RWE_M	0
வரம் என்பதன் பொருள் வெம்மை	வறம் என்பதன் பொருள் வெம்மை	RWE_M	0
வறவு என்பதன் பொருள் வருமானம்	வரவு என்பதன் பொருள் வருமானம்	RWE_M	0
வறவு என்பதன் பொருள் வழி	வரவு என்பதன் பொருள் வழி	RWE_M	0
வரவு என்பதன் பொருள் கஞ்சி	வறவு என்பதன் பொருள் கஞ்சி	RWE_M	0
வறப்பு என்பதன் பொருள் எல்லை	வரப்பு என்பதன் பொருள் எல்லை	RWE_M	0
வறப்பு என்பதன் பொருள் வரம்பு	வரப்பு என்பதன் பொருள் வரம்பு	RWE_M	0
வரப்பு என்பதன் பொருள் வறட்சி	வறப்பு என்பதன் பொருள் வறட்சி	RWE_M	0
வரப்பு என்பதன் பொருள் வறுமை	வறப்பு என்பதன் பொருள் வறுமை	RWE_M	0
வரப்பு என்பதன் பொருள் வற்றுதல்	வறப்பு என்பதன் பொருள் வற்றுதல்	RWE_M	0
விறகு என்பதன் பொருள் விவேகம்	விரகு என்பதன் பொருள் விவேகம்	RWE_M	0
விறகு என்பதன் பொருள் உபாயம்	விரகு என்பதன் பொருள் உபாயம்	RWE_M	0
விறகு என்பதன் பொருள் உற்சாகம்	விரகு என்பதன் பொருள் உற்சாகம்	RWE_M	0
விறகு என்பதன் பொருள் புத்தி	விரகு என்பதன் பொருள் புத்தி	RWE_M	0
விறகு என்பதன் பொருள் கபடம்	விரகு என்பதன் பொருள் கபடம்	RWE_M	0
விரகு என்பதன் பொருள் எரிகட்டை	விறகு என்பதன் பொருள் எரிகட்டை	RWE_M	0
விறலி என்பதன் பொருள் மஞ்சள்	விரலி என்பதன் பொருள் மஞ்சள்	RWE_M	0
விரலி என்பதன் பொருள் மெய்ப்பாடு தோன்ற ஆடிப்பாடும் பெண்	விறலி என்பதன் பொருள் மெய்ப்பாடு தோன்ற ஆடிப்பாடும் பெண்	RWE_M	0
விரலி என்பதன் பொருள் பதினாறு வயதினள்	விறலி என்பதன் பொருள் பதினாறு வயதினள்	RWE_M	0
விறல் என்பதன் பொருள் மனித உடலில் உள்ள உறுப்பு	விரல் என்பதன் பொருள் மனித உடலில் உள்ள உறுப்பு	RWE_M	0
விரல் என்பதன் பொருள் பெருமை	விறல் என்பதன் பொருள் பெருமை	RWE_M	0
விரல் என்பதன் பொருள் வீரம்	விறல் என்பதன் பொருள் வீரம்	RWE_M	0
விரல் என்பதன் பொருள் வெற்றி	விறல் என்பதன் பொருள் வெற்றி	RWE_M	0
விரல் என்பதன் பொருள் மிகுதி	விறல் என்பதன் பொருள் மிகுதி	RWE_M	0
விரல் என்பதன் பொருள் வலி	விறல் என்பதன் பொருள் வலி	RWE_M	0
விறாய் என்பதன் பொருள் விறகு	விராய் என்பதன் பொருள் விறகு	RWE_M	0
விராய் என்பதன் பொருள் செருக்கு	விறாய் என்பதன் பொருள் செருக்கு	RWE_M	0
விராய் என்பதன் பொருள் இறுமாப்பு	விறாய் என்பதன் பொருள் இறுமாப்பு	RWE_M	0
வெறு என்பதன் பொருள் அச்சம்	வெரு என்பதன் பொருள் அச்சம்	RWE_M	0
வெரு என்பதன் பொருள் வெறுத்து விடு	வெறு என்பதன் பொருள் வெறுத்து விடு	RWE_M	0
வெறல் என்பதன் பொருள் மூங்கில்	வெரல் என்பதன் பொருள் மூங்கில்	RWE_M	0
வெரல் என்பதன் பொருள் வெல்லுதல்	வெறல் என்பதன் பொருள் வெல்லுதல்	RWE_M	0
வெரல் என்பதன் பொருள் வெற்றி கொள்ளல்	வெறல் என்பதன் பொருள் வெற்றி கொள்ளல்	RWE_M	0
விறை என்பதன் பொருள் விரைந்து செல்	விரை என்பதன் பொருள் விரைந்து செல்	RWE_M	0
விரை என்பதன் பொருள் மரத்துப் போதல்	விறை என்பதன் பொருள் மரத்துப் போதல்	RWE_M	0
ஆரம் ஒரு கருவி   	அரம் ஒரு கருவி   	RWE_KN	0
அரம் என்பதன் பொருள் பூமாலை 	ஆரம் என்பதன் பொருள் பூமாலை 	RWE_KN	0
புடலையை ஆரி	புடலையை அரி	RWE_KN	1
அரி என்பதன் பொருள் மேன்மை 	ஆரி என்பதன் பொருள் மேன்மை 	RWE_KN	0
ஆரை என்பதன் பொருள் பாதி 	அரை என்பதன் பொருள் பாதி 	RWE_KN	0
அரை என்பதன் பொருள் நீராரைச் செடி 	ஆரை என்பதன் பொருள் நீராரைச் செடி 	RWE_KN	0
ஈரம் என்பதன் பொருள் இரம்மியம் 	இரம் என்பதன் பொருள் இரம்மியம் 	RWE_KN	0
இரம் என்பதன் பொருள் குளிர்ச்சி 	ஈரம் என்பதன் பொருள் குளிர்ச்சி 	RWE_KN	0
தோலை ஊரி	தோலை உரி 	RWE_KN	1
உரி என்பதன் பொருள் புல்லுருவி 	ஊரி என்பதன் பொருள் புல்லுருவி 	RWE_KN	0
கட்டித் தொங்க விடும் ஊறி	கட்டித் தொங்க விடும் உறி	RWE_KN	3
தாள் நீரில் உறி இருந்தது 	தாள் நீரில் ஊறி இருந்தது 	RWE_KN	2
ஊரை என்றால் சொல்	உரை என்றால் சொல்	RWE_KN	0
உரை விட்டு வா	ஊரை விட்டு வா	RWE_KN	0
தலையணை ஊறை	தலையணை உறை 	RWE_KN	1
உறை என்பதன் பொருள் சவ்வரிசி 	ஊறை என்பதன் பொருள் சவ்வரிசி 	RWE_KN	0
ஏரி என்றால் கொளுத்து 	எரி என்றால் கொளுத்து 	RWE_KN	0
எரி என்பதன் பொருள் நீர்நிலை 	ஏரி என்பதன் பொருள் நீர்நிலை 	RWE_KN	0
ஏறி என்றால் தூக்கி வீசு 	எறி என்றால் தூக்கி வீசு 	RWE_KN	0
பேருந்தில் எறி வந்தேன் 	பேருந்தில் ஏறி வந்தேன் 	RWE_KN	1
காரம் என்பதன் பொருள் கை 	கரம் என்பதன் பொருள் கை 	RWE_KN	0
கரம் என்பதன் பொருள் உறைப்பு 	காரம் என்பதன் பொருள் உறைப்பு 	RWE_KN	0
கடற்காரை 	கடற்கரை 	RWE_KN	0
கரை என்பதன் பொருள் சுண்ணச்சாந்து	காரை என்பதன் பொருள் சுண்ணச்சாந்து	RWE_KN	0
பட்டைக்கறை	பட்டைக்காறை	RWE_KN	0
கறையெலும்பு	காறையெலும்பு	RWE_KN	0
துணியில் காறை உள்ளது 	துணியில் கறை உள்ளது 	RWE_KN	1
குறவை என்பதன் பொருள் நியாய சபை 	கூறவை என்பதன் பொருள் நியாய சபை 	RWE_KN	0
கூறவை ஒரு வகை மீன் 	குறவை ஒரு வகை மீன் 	RWE_KN	0
வீட்டின் மேல் குரை இருக்கும் 	வீட்டின் மேல் கூரை இருக்கும் 	RWE_KN	2
கூரை என்பதன் பொருள் நாய் குரைத்தல் 	குரை என்பதன் பொருள் நாய் குரைத்தல் 	RWE_KN	0
எடையைக் கூறை	எடையைக் குறை	RWE_KN	1
குறை என்பதன் பொருள் ஆடை 	கூறை என்பதன் பொருள் ஆடை 	RWE_KN	0
செரி என்பதன் பொருள் ஊர் 	சேரி என்பதன் பொருள் ஊர் 	RWE_KN	0
சேரி என்றால் செரிமானம் ஆதல் 	செரி என்றால் செரிமானம் ஆதல் 	RWE_KN	0
செறி ஒரு கடல் மீன் 	சேறி ஒரு கடல் மீன் 	RWE_KN	0
சேறி என்றால் திணித்தல் 	செறி என்றால் திணித்தல் 	RWE_KN	0
பூச்சோரி	பூச்சொரி	RWE_KN	0
சொரி என்பதன் பொருள் இரத்தம் 	சோரி என்பதன் பொருள் இரத்தம் 	RWE_KN	0
தீரை என்றால் அலை 	திரை என்றால் அலை 	RWE_KN	0
திரை என்பதன் பொருள் வீரம் 	தீரை என்பதன் பொருள் வீரம் 	RWE_KN	0
தீரைப்படம் 	திரைப்படம் 	RWE_KN	0
மூடி கொட்டியது 	முடி கொட்டியது 	RWE_KN	0
பானையை முடி வை	பானையை மூடி வை	RWE_KN	1
நாரை என்பது வெள்ளை முடி	நரை என்பது வெள்ளை முடி	RWE_KN	0
நரை ஒரு பறவை 	நாரை ஒரு பறவை 	RWE_KN	0
நீரை என்றால் வரிசை 	நிரை என்றால் வரிசை 	RWE_KN	0
நிரை பானையில் நிரப்பினான் 	நீரை பானையில் நிரப்பினான் 	RWE_KN	0
பரி என்றால் குதிரை 	பரி என்றால் குதிரை 	RWE_KN	0
பாரி என்பதன் பொருள் பூமி 	பாரி என்பதன் பொருள் பூமி 	RWE_KN	0
பாரை என்பதன் பொருள் பார்வதி 	பரை என்பதன் பொருள் பார்வதி 	RWE_KN	0
பரை எடு 	பாரை எடு 	RWE_KN	0
பாறை இசை 	பறை இசை 	RWE_KN	0
பறை மேல் அமர்ந்தான் 	பாறை மேல் அமர்ந்தான் 	RWE_KN	0
பீரைக் கூட்டு 	பீரைக் கூட்டு 	RWE_KN	0
பிரை என்றால் உறைமோர் 	பிரை என்றால் உறைமோர் 	RWE_KN	0
பொரிப் பழங்குடி	போரிப் பழங்குடி	RWE_KN	0
சோளப் போரி	சோளப் பொரி 	RWE_KN	1
பொறி என்பதன் பொருள் போல் இருக்கிறாய்	போறி என்பதன் பொருள் போல் இருக்கிறாய்	RWE_KN	0
போறி என்றால் இயந்திரம் 	பொறி என்றால் இயந்திரம் 	RWE_KN	0
போருக்கு என்றால் பருக்கை 	பொருக்கு என்றால் பருக்கை 	RWE_KN	0
பொருக்கு வீரர்கள் தேவை 	போருக்கு வீரர்கள் தேவை 	RWE_KN	0
மாரி என்றால் சாகாமை 	மரி என்றால் சாகாமை 	RWE_KN	0
மரி என்றால் மழை 	மாரி என்றால் மழை 	RWE_KN	0
சாலையை மாறி	சாலையை மறி 	RWE_KN	1
வண்ணம் மறிப் போனது 	வண்ணம் மாறிப் போனது 	RWE_KN	1
மாரை என்றால் மான் 	மரை என்றால் மான் 	RWE_KN	0
மரைத் தொட்டது மாலை   	மாரைத் தொட்டது மாலை   	RWE_KN	0
மறை பாண்டி மண்டலத்துள்ள ஒரு நாடு	மாறை பாண்டி மண்டலத்துள்ள ஒரு நாடு	RWE_KN	0
உண்மையை மாறை	உண்மையை மறை	RWE_KN	1
மாறை என்பதன் பொருள் வேதம் 	மறை என்பதன் பொருள் வேதம் 	RWE_KN	0
கருவீரல்	கருவீரல்	RWE_KN	0
கையில் விரல்கள் உள்ளன 	கையில் விரல்கள் உள்ளன 	RWE_KN	1
விறல் என்பதன் பொருள் வெடிப்பு	வீறல் என்பதன் பொருள் வெடிப்பு	RWE_KN	0
வீறல் என்றால் வெற்றி என்று பொருள் 	விறல் என்றால் வெற்றி என்று பொருள் 	RWE_KN	0
அழி என்பதன் பொருள் கடல் 	ஆழி என்பதன் பொருள் கடல் 	RWE_KN	0
அலி என்றால் ஆலங்கட்டி 	ஆலி என்றால் ஆலங்கட்டி 	RWE_KN	0
முகமது ஆலி 	முகமது அலி 	RWE_KN	1
அளி என்பதன் பொருள் கிளிஞ்சில் வகை	ஆளி என்பதன் பொருள் கிளிஞ்சில் வகை	RWE_KN	0
பரிசு ஆளி	பரிசு அளி	RWE_KN	1
கடல் ஆலை	கடல் அலை 	RWE_KN	1
கரும்பு அலை  	கரும்பு ஆலை 	RWE_KN	1
ஆளை என்றால் வளை என்று பொருள் 	அளை என்றால் வளை என்று பொருள் 	RWE_KN	0
வேலை அளை நியமித்தாள் 	வேலை ஆளை நியமித்தாள் 	RWE_KN	1
ஆல் என்றால் துன்பம் 	அல் என்றால் துன்பம் 	RWE_KN	0
அல் கிளை	ஆல் கிளை	RWE_KN	0
ஆள் என்பதன் பொருள் அள்ளிக் கொள்ளுதல் 	அள் என்பதன் பொருள் அள்ளிக் கொள்ளுதல் 	RWE_KN	0
வேலை அள் 	வேலை ஆள் 	RWE_KN	1
இளை என்பதன் பொருள் இழைப்பு	ஈளை என்பதன் பொருள் இழைப்பு	RWE_KN	0
உடல் ஈளை 	உடல் இளை 	RWE_KN	1
காலில் பாடும் 	காலில் படும் 	RWE_KN	1
பாட்டுப் படு 	பாட்டுப் பாடு 	RWE_KN	1
வாடு என்பதன் பொருள் தழும்பு 	வடு என்பதன் பொருள் தழும்பு 	RWE_KN	0
வடு என்பதன் பொருள் சோர்வு 	வாடு என்பதன் பொருள் சோர்வு 	RWE_KN	0
மாடு என்பதன் பொருள் நீர்நிலை 	மடு என்பதன் பொருள் நீர்நிலை 	RWE_KN	0
மடு ஒரு விலங்கு 	மாடு ஒரு விலங்கு 	RWE_KN	0
உதவியை நடு 	உதவியை நாடு 	RWE_KN	1
இந்திய நடு 	இந்திய நாடு 	RWE_KN	1
நாடுக் கடல் 	நடுக் கடல் 	RWE_KN	0
செடியை நாடு	செடியை நடு 	RWE_KN	1
பாணி என்றால் வேலை 	பணி என்றால் வேலை 	RWE_KN	0
அவன் பாணி பாடினான் 	அவன் பாணி பாடினான் 	RWE_KN	1
பனி நீர் ஆகாரம் பருகுபவர் 	பானி நீர் ஆகாரம் பருகுபவர் 	RWE_KN	0
பானி மலை 	பனி மலை 	RWE_KN	0
மணி மகுடம் 	மணி மகுடம் 	RWE_KN	0
மாணி என்பதன் பொருள் மாணவர் 	மாணி என்பதன் பொருள் மாணவர் 	RWE_KN	0
தனி என்பதன் பொருள் இடம் 	தானி என்பதன் பொருள் இடம் 	RWE_KN	0
தானி நாடு  	தனி நாடு  	RWE_KN	0
மானம் மகிழ்ந்தாள் 	மனம் மகிழ்ந்தாள் 	RWE_KN	0
மனமும் அறிவும் மனிதர்க்கு அழகு  	மானமும் அறிவும் மனிதர்க்கு அழகு  	RWE_KN	0
மணம் என்பதன் பொருள் மாட்சிமை	மாணம் என்பதன் பொருள் மாட்சிமை	RWE_KN	0
மாணம் என்பதன் பொருள் வாசனை	மணம் என்பதன் பொருள் வாசனை	RWE_KN	0
பானம் பூ 	பனம் பூ 	RWE_KN	0
குளிர் பனம்	குளிர் பானம்	RWE_KN	1
பாணம்  வாழ அவசியம் 	பணம்  வாழ அவசியம் 	RWE_KN	0
பணம்  என்பதன் பொருள் அம்பு	பாணம்  என்பதன் பொருள் அம்பு	RWE_KN	0
வனம் மேகமூட்டமாக இருந்தது 	வானம் மேகமூட்டமாக இருந்தது 	RWE_KN	0
வானம் என்பதன் பொருள் காடு 	வனம் என்பதன் பொருள் காடு 	RWE_KN	0
உடல் தனம் செய்தாள் 	உடல் தானம் செய்தாள் 	RWE_KN	1
தானம் என்பதன் பொருள் செல்வம் 	தனம் என்பதன் பொருள் செல்வம் 	RWE_KN	0
சானம் என்பதன் பொருள் மக்கள்	சனம் என்பதன் பொருள் மக்கள்	RWE_KN	0
சனம் என்பதன் பொருள் பெருங்காயம்	சானம் என்பதன் பொருள் பெருங்காயம்	RWE_KN	0
சாணம் என்பதன் பொருள் சணல் 	சணம் என்பதன் பொருள் சணல் 	RWE_KN	0
மாட்டுச் சணம் 	மாட்டுச் சாணம் 	RWE_KN	1
மானை காட்டினாள்  	மனை காட்டினாள்  	RWE_KN	0
மனைப் பிடித்தாள்	மானைப் பிடித்தாள்	RWE_KN	0
பானை மரம் 	பனை மரம் 	RWE_KN	0
மண் பனை 	மண் பானை 	RWE_KN	1
தனை என்பதன் பொருள் படை 	தானை என்பதன் பொருள் படை 	RWE_KN	0
தாய் தானை மறந்தாய் 	தாய் தனை மறந்தாய் 	RWE_KN	1
யானைப் பாடை	யானைப் படை 	RWE_KN	1
படையில் போனான் 	பாடையில் போனான் 	RWE_KN	0
வாடை சுவையாக இருந்தது 	வடை சுவையாக இருந்தது 	RWE_KN	0
வடைக் காற்று 	வாடைக் காற்று 	RWE_KN	0
வேகத் தாடை 	வேகத் தடை 	RWE_KN	1
தடை என்பது மேல் வாய்	தாடை என்பது மேல் வாய்	RWE_KN	0
மாடை என்பதன் பொருள் நீரணை	மடை என்பதன் பொருள் நீரணை	RWE_KN	0
மடை என்பதன் பொருள் பழைய நாணயம்	மாடை என்பதன் பொருள் பழைய நாணயம்	RWE_KN	0
யானையின் பாலம்	யானையின் பலம் 	RWE_KN	1
பலம் என்பதன் பொருள் மரக்கிளை	பாலம் என்பதன் பொருள் மரக்கிளை	RWE_KN	0
காளி என்பதன் பொருள்  மகிழ்தல் 	களி என்பதன் பொருள்  மகிழ்தல் 	RWE_KN	0
களி என்பதன் பொருள் துர்க்கை	காளி என்பதன் பொருள் துர்க்கை	RWE_KN	0
காலி என்றால் பஞ்சம் 	கலி என்றால் பஞ்சம் 	RWE_KN	0
உணவு கலி ஆகிப் போனது 	உணவு காலி ஆகிப் போனது 	RWE_KN	1
காழி என்றால் உப்பளம் 	கழி என்றால் உப்பளம் 	RWE_KN	0
சீர்கழி ஒரு இடப் பெயர்  	சீர்காழி ஒரு இடப் பெயர்  	RWE_KN	0
நடனக் காலை	நடனக் கலை	RWE_KN	1
கலை நேரம் 	காலை நேரம் 	RWE_KN	0
காளை பறித்தாள் 	களை பறித்தாள் 	RWE_KN	0
களை மாடு 	காளை மாடு 	RWE_KN	0
சூள் என்பதன் பொருள் உறைப்பு	சுள் என்பதன் பொருள் உறைப்பு	RWE_KN	0
சுள் என்பதன் பொருள் சபதம் 	சூள் என்பதன் பொருள் சபதம் 	RWE_KN	0
தளைக் கொடு  	தாளைக் கொடு  	RWE_KN	0
தாளை என்பதன் பொருள் கட்டு 	தளை என்பதன் பொருள் கட்டு 	RWE_KN	0
தழை ஒரு வாசனைச் செடி	தாழை ஒரு வாசனைச் செடி	RWE_KN	0
தாழை என்பதன் பொருள் தளிர் 	தழை என்பதன் பொருள் தளிர் 	RWE_KN	0
வலி ஒரு கவிஞர் 	வாலி ஒரு கவிஞர் 	RWE_KN	0
தலை வாலி 	தலை வலி 	RWE_KN	1
வாளி என்பதன் பொருள் காற்று 	வளி என்பதன் பொருள் காற்று 	RWE_KN	0
வளி நீர் நிரப்பும் பொருள்    	வாளி நீர் நிரப்பும் பொருள்    	RWE_KN	0
கிராமம் செல்லும் வாழி 	கிராமம் செல்லும் வழி 	RWE_KN	2
வழி என்றால் வாழ்க 	வாழி என்றால் வாழ்க 	RWE_KN	0
மீன் வாலை	மீன் வலை	RWE_KN	1
நாய் வலை மிதித்தான் 	நாய் வாலை மிதித்தான் 	RWE_KN	1
வளை மீன் வகை 	வாளை மீன் வகை 	RWE_KN	0
உடலை வாளை	உடலை வளை 	RWE_KN	1
வால் என்பதன் பொருள் வலிமை 	வல் என்பதன் பொருள் வலிமை 	RWE_KN	0
நாய் வல் 	நாய் வால் 	RWE_KN	1
வாள் இதழ் மாலை	வள் இதழ் மாலை	RWE_KN	0
வள் கூர்மையாக இருந்தது 	வாள் கூர்மையாக இருந்தது 	RWE_KN	0
ஆணி என்பதன் பொருள் அழகு  	அணி என்பதன் பொருள் அழகு  	RWE_KN	0
கால்பந்து ஆணி 	கால்பந்து அணி 	RWE_KN	1
அணி கொடு	ஆணி கொடு	RWE_KN	0
ஆனி என்பதன் பொருள் நெற்பொறி	அனி என்பதன் பொருள் நெற்பொறி	RWE_KN	0
அனி ஒரு தமிழ் மாதம் 	ஆனி ஒரு தமிழ் மாதம் 	RWE_KN	0
ஆணை என்பதன் பொருள் அணைத்துக் கொள்ளுதல்	அணை என்பதன் பொருள் அணைத்துக் கொள்ளுதல்	RWE_KN	0
ஆணை என்பதன் பொருள் படுக்கை	அணை என்பதன் பொருள் படுக்கை	RWE_KN	0
கல்லால் ஆணையைக் கட்டினாள் 	கல்லால் அணையைக் கட்டினாள் 	RWE_KN	1
அரசு அணை 	அரசு ஆணை 	RWE_KN	1
ஆனை என்பதன் பொருள் அன்னை	அனை என்பதன் பொருள் அன்னை	RWE_KN	0
ஆனை என்பதன் பொருள் மீன்	அனை என்பதன் பொருள் மீன்	RWE_KN	0
அனை என்பதன் பொருள் யானை 	ஆனை என்பதன் பொருள் யானை 	RWE_KN	0
கயிற்றால் காட்டு 	கயிற்றால் கட்டு 	RWE_KN	1
கட்டுத் தீ  	காட்டுத் தீ  	RWE_KN	0
ஆண்மை என்பதன் பொருள் அருகில்	அண்மை என்பதன் பொருள் அருகில்	RWE_KN	0
அண்மைக் குறைவு  	ஆண்மைக் குறைவு  	RWE_KN	0
ஆவல் என்பதன் பொருள் நெற்பொரி	அவல் என்பதன் பொருள் நெற்பொரி	RWE_KN	0
நலமறிய அவல் 	நலமறிய ஆவல் 	RWE_KN	1
ஆண் என்பதன் பொருள் கயிறு	அண் என்பதன் பொருள் கயிறு	RWE_KN	0
அண் என்பதன் பொருள் ஆடவன்	ஆண் என்பதன் பொருள் ஆடவன்	RWE_KN	0
ஊன் சட்டை 	உன் சட்டை  	RWE_KN	0
உன் என்பதன் பொருள் தசை 	ஊன் என்பதன் பொருள் தசை 	RWE_KN	0
ஊண் என்பதன் பொருள் உண்ணுதல்	உண் என்பதன் பொருள் உண்ணுதல்	RWE_KN	0
உண் என்பதன் பொருள் உணவு 	ஊண் என்பதன் பொருள் உணவு 	RWE_KN	0
எண் என்பதன் பொருள் எல்லை 	ஏண் என்பதன் பொருள் எல்லை 	RWE_KN	0
வண்டி ஏண் 	வண்டி எண் 	RWE_KN	1
ஏன் படம் 	என் படம் 	RWE_KN	0
என் பாடினாய்?	ஏன் பாடினாய்?	RWE_KN	0
ஏனை மறந்தேன் 	எனை மறந்தேன் 	RWE_KN	0
எனை என்பதன் பொருள் மற்றது	ஏனை என்பதன் பொருள் மற்றது	RWE_KN	0
கனகம் என்பதன் பொருள் காடு	கானகம் என்பதன் பொருள் காடு	RWE_KN	0
கானகம் என்பதன் பொருள் பொன்	கனகம் என்பதன் பொருள் பொன்	RWE_KN	0
கணி என்பதன் பொருள் நிலம் 	காணி என்பதன் பொருள் நிலம் 	RWE_KN	0
காணி என்பதன் பொருள் கணித்தல்	கணி என்பதன் பொருள் கணித்தல்	RWE_KN	0
காணம் என்பதன் பொருள் கூட்டம்	கணம் என்பதன் பொருள் கூட்டம்	RWE_KN	0
கணம் என்பதன் பொருள் செக்கு	காணம் என்பதன் பொருள் செக்கு	RWE_KN	0
கானம் என்பதன் பொருள் பாரம்	கனம் என்பதன் பொருள் பாரம்	RWE_KN	0
கனம் என்பதன் பொருள் காடு	கானம் என்பதன் பொருள் காடு	RWE_KN	0
காண் என்பதன் பொருள் ஓர் உறுப்பு	கண் என்பதன் பொருள் ஓர் உறுப்பு	RWE_KN	0
படத்தைக் கண் 	படத்தைக் காண் 	RWE_KN	1
கான் என்பதன் பொருள் கல் 	கன் என்பதன் பொருள் கல் 	RWE_KN	0
கன் என்பதன் பொருள் காடு	கான் என்பதன் பொருள் காடு	RWE_KN	0
அது தன் 	அது தான் 	RWE_KN	1
தான் பொருள் 	தன் பொருள் 	RWE_KN	0
கூனி என்பதன் பொருள் குனிதல்	குனி என்பதன் பொருள் குனிதல்	RWE_KN	0
குனிக் குறுகினான் 	கூனிக் குறுகினான் 	RWE_KN	0
பாடிக் கோள் 	பாடிக் கொள்	RWE_KN	1
சனி ஒரு கொள் 	சனி ஒரு கோள் 	RWE_KN	2
மான் என்பதன் பொருள் அரசன் 	மன் என்பதன் பொருள் அரசன் 	RWE_KN	0
மன் ஒரு விலங்கு	மான் ஒரு விலங்கு	RWE_KN	0
கனல் என்பதன் பொருள் பாலை	கானல் என்பதன் பொருள் பாலை	RWE_KN	0
கானல் என்பதன் பொருள் நெருப்பு	கனல் என்பதன் பொருள் நெருப்பு	RWE_KN	0
செங்கல் சுளை	செங்கல் சூளை	RWE_KN	1
பலாச் சூளை	பலாச் சுளை	RWE_KN	1
தேன் என்பதன் பொருள் தெற்கு	தென் என்பதன் பொருள் தெற்கு	RWE_KN	0
தென் சுவை 	தேன் சுவை 	RWE_KN	0
சரி என்பது எறும்புக் கூட்டம்	சாரி என்பது எறும்புக் கூட்டம்	RWE_KN	0
சாரி தவறு	சரி தவறு	RWE_KN	0
பரி வள்ளல் 	பாரி வள்ளல் 	RWE_KN	0
பாரி என்பதன் பொருள் குதிரை 	பரி என்பதன் பொருள் குதிரை 	RWE_KN	0
வாரி கட்ட வேண்டும் 	வரி கட்ட வேண்டும் 	RWE_KN	0
வரி அணைத்தாள்	வாரி அணைத்தாள்	RWE_KN	0
இரண்டாம் வாரி	இரண்டாம் வரி 	RWE_KN	1
நிலக் காரி 	நிலக் கரி 	RWE_KN	1
கரி என்பதன் பொருள் காக்கை	காரி என்பதன் பொருள் காக்கை	RWE_KN	0
நாரி ஒரு விலங்கு 	நரி ஒரு விலங்கு 	RWE_KN	0
நரி என்பதன் பொருள் பன்னாடை	நாரி என்பதன் பொருள் பன்னாடை	RWE_KN	0
நரி என்பதன் பொருள் யாழ் நரம்பு	நாரி என்பதன் பொருள் யாழ் நரம்பு	RWE_KN	0
மாரியே வாழ்க 	மரியே வாழ்க 	RWE_KN	0
மரி என்பதன் பொருள் மழை	மாரி என்பதன் பொருள் மழை	RWE_KN	0
பூனை என்பதன் பொருள் இட்டுக்கட்டுதல்	புனை என்பதன் பொருள் இட்டுக்கட்டுதல்	RWE_KN	0
புனை ஒரு விலங்கு 	பூனை ஒரு விலங்கு 	RWE_KN	0
ஆழம் என்பதன் பொருள் பிணம்	அழம் என்பதன் பொருள் பிணம்	RWE_KN	0
குளம் அழமாக உள்ளது 	குளம் ஆழமாக உள்ளது 	RWE_KN	1
ஆலம் என்பதன் பொருள் கலப்பை	அலம் என்பதன் பொருள் கலப்பை	RWE_KN	0
அல மரம் 	ஆல மரம் 	RWE_KN	0
ஊழி என்பதன் பொருள் இடம்	உழி என்பதன் பொருள் இடம்	RWE_KN	0
உழி என்பது ஒரு கால அளவை	ஊழி என்பது ஒரு கால அளவை	RWE_KN	0
நரி உளை விட்டது	நரி ஊளை விட்டது	RWE_KN	1
ஊளை என்பதன் பொருள் பிடரி மயிர்	உளை என்பதன் பொருள் பிடரி மயிர்	RWE_KN	0
ஊளை என்பதன் பொருள் சேறு	உளை என்பதன் பொருள் சேறு	RWE_KN	0
ஊளை என்பதன் பொருள் தலை	உளை என்பதன் பொருள் தலை	RWE_KN	0
உழை என்பதன் பொருள் பித்தம்	ஊழை என்பதன் பொருள் பித்தம்	RWE_KN	0
ஊழை என்பதன் பொருள் பாடுபடு	உழை என்பதன் பொருள் பாடுபடு	RWE_KN	0
ஊழை என்பதன் பொருள் பக்கம்	உழை என்பதன் பொருள் பக்கம்	RWE_KN	0
ஊழை என்பதன் பொருள் கலைமான்	உழை என்பதன் பொருள் கலைமான்	RWE_KN	0
ஏழு என்பதன் பொருள் எழுந்திரு	எழு என்பதன் பொருள் எழுந்திரு	RWE_KN	0
ஏழு என்பதன் பொருள் தூண்	எழு என்பதன் பொருள் தூண்	RWE_KN	0
எழு படகுகள் 	ஏழு படகுகள் 	RWE_KN	0
ஓல் என்பதன் பொருள் ஒலிக்குறிப்பு	ஒல் என்பதன் பொருள் ஒலிக்குறிப்பு	RWE_KN	0
ஒல் என்பதன் பொருள் ஒலி 	ஓல் என்பதன் பொருள் ஒலி 	RWE_KN	0
ஒல் என்பதன் பொருள் தாலாட்டு	ஓல் என்பதன் பொருள் தாலாட்டு	RWE_KN	0
கால் என்பதன் பொருள் மலை	கல் என்பதன் பொருள் மலை	RWE_KN	0
கால் என்பதன் பொருள் பாறை	கல் என்பதன் பொருள் பாறை	RWE_KN	0
கால் என்பதன் பொருள் சிறுகல்	கல் என்பதன் பொருள் சிறுகல்	RWE_KN	0
கல் விரல்கள் 	கால் விரல்கள் 	RWE_KN	0
பந்தல் கல் 	பந்தல் கால் 	RWE_KN	1
பல்காரர் 	பால்காரர்  	RWE_KN	0
பால் பொருள் அங்காடி 	பல் பொருள் அங்காடி 	RWE_KN	0
பால் வலிக்கும் 	பல் வலிக்கும் 	RWE_KN	0
வால் என்பதன் பொருள் வலிமை 	வல் என்பதன் பொருள் வலிமை 	RWE_KN	0
குதிரை வல் 	குதிரை வால் 	RWE_KN	1
குலி வேலை 	கூலி வேலை 	RWE_KN	0
கூலி என்பதன் பொருள் மனைவி	குலி என்பதன் பொருள் மனைவி	RWE_KN	0
குளி என்பதன் பொருள் கூட்டம் 	கூளி என்பதன் பொருள் கூட்டம் 	RWE_KN	0
குளி என்பதன் பொருள் குடும்பம் 	கூளி என்பதன் பொருள் குடும்பம் 	RWE_KN	0
குளி என்பதன் பொருள் படைத் தலைவன் 	கூளி என்பதன் பொருள் படைத் தலைவன் 	RWE_KN	0
கூளி என்பதன் பொருள் நீராடு	குளி என்பதன் பொருள் நீராடு	RWE_KN	0
குளி என்பதன் பொருள் காளை	கூளி என்பதன் பொருள் காளை	RWE_KN	0
குளி என்பதன் பொருள் வீரர்	கூளி என்பதன் பொருள் வீரர்	RWE_KN	0
குளி என்பதன் பொருள் படைவீரர்	கூளி என்பதன் பொருள் படைவீரர்	RWE_KN	0
குளி என்பதன் பொருள் வணங்கி நிற்பவர்	கூளி என்பதன் பொருள் வணங்கி நிற்பவர்	RWE_KN	0
குளி என்பதன் பொருள் ஏவலாளர்	கூளி என்பதன் பொருள் ஏவலாளர்	RWE_KN	0
கூலம் என்பதன் பொருள் ஜாதியின் உட்பிரிவு	குலம் என்பதன் பொருள் ஜாதியின் உட்பிரிவு	RWE_KN	0
குலம் என்பதன் பொருள் தானியம்	கூலம் என்பதன் பொருள் தானியம்	RWE_KN	0
கூளம் என்பதன் பொருள் நீர்நிலை	குளம் என்பதன் பொருள் நீர்நிலை	RWE_KN	0
கூளம் என்பதன் பொருள் கண்மாய்	குளம் என்பதன் பொருள் கண்மாய்	RWE_KN	0
கூளம் என்பதன் பொருள் ஏரி	குளம் என்பதன் பொருள் ஏரி	RWE_KN	0
குப்பையும் குளமும்	குப்பையும் கூளமும்	RWE_KN	1
கூழை என்பதன் பொருள் குண்டலம்	குழை என்பதன் பொருள் குண்டலம்	RWE_KN	0
கூழை என்பதன் பொருள் குழைந்துபோதல்	குழை என்பதன் பொருள் குழைந்துபோதல்	RWE_KN	0
குழை என்பதன் பொருள் மயில் தோகை 	கூழை என்பதன் பொருள் மயில் தோகை 	RWE_KN	0
குழை என்பதன் பொருள் பெண்டிர் தலை முடி 	கூழை என்பதன் பொருள் பெண்டிர் தலை முடி 	RWE_KN	0
குழை என்பதன் பொருள் வால் 	கூழை என்பதன் பொருள் வால் 	RWE_KN	0
அசை என்பதன் பொருள் ஆவல் 	ஆசை என்பதன் பொருள் ஆவல் 	RWE_KN	0
ஆசை என்பதன் பொருள் அசைவு 	அசை என்பதன் பொருள் அசைவு 	RWE_KN	0
கோழை என்பதன் பொருள் கொல்லுதல்	கொலை என்பதன் பொருள் கொல்லுதல்	RWE_KN	0
கோளை என்பதன் பொருள் கோட்பாடு	கொளை என்பதன் பொருள் கோட்பாடு	RWE_KN	0
கோளை என்பதன் பொருள் பயன்	கொளை என்பதன் பொருள் பயன்	RWE_KN	0
கோளை என்பதன் பொருள் இசைப்பாட்டு	கொளை என்பதன் பொருள் இசைப்பாட்டு	RWE_KN	0
கோளை என்பதன் பொருள் தாளம்	கொளை என்பதன் பொருள் தாளம்	RWE_KN	0
கொலை என்பதன் பொருள் கபம்	கோழை என்பதன் பொருள் கபம்	RWE_KN	0
கொலை என்பதன் பொருள் உமிழ் நீர்	கோழை என்பதன் பொருள் உமிழ் நீர்	RWE_KN	0
கொலை என்பதன் பொருள் மனத் திடமில்லாதவன்	கோழை என்பதன் பொருள் மனத் திடமில்லாதவன்	RWE_KN	0
கோளை என்பதன் பொருள் எலி	கோளை என்பதன் பொருள் எலி	RWE_KN	0
கோளை என்பதன் பொருள் தோழி	கோளை என்பதன் பொருள் தோழி	RWE_KN	0
சலம் என்பதன் பொருள் வித்தை 	சாலம் என்பதன் பொருள் வித்தை 	RWE_KN	0
சலம் என்பதன் பொருள் நடிப்பு	சாலம் என்பதன் பொருள் நடிப்பு	RWE_KN	0
சலம் என்பதன் பொருள் கூட்டம்	சாலம் என்பதன் பொருள் கூட்டம்	RWE_KN	0
சாலம் என்பதன் பொருள் நீர்	சலம் என்பதன் பொருள் நீர்	RWE_KN	0
சாலம் என்பதன் பொருள் சிறுநீர்	சலம் என்பதன் பொருள் சிறுநீர்	RWE_KN	0
சாலம் என்பதன் பொருள் குளிர்	சலம் என்பதன் பொருள் குளிர்	RWE_KN	0
சளம் என்பதன் பொருள் குங்கிலியம்	சாளம் என்பதன் பொருள் குங்கிலியம்	RWE_KN	0
சளம் என்பதன் பொருள் மணல்	சாளம் என்பதன் பொருள் மணல்	RWE_KN	0
சாளம் என்பதன் பொருள் பொய்	சளம் என்பதன் பொருள் பொய்	RWE_KN	0
சாளம் என்பதன் பொருள் துன்பம்	சளம் என்பதன் பொருள் துன்பம்	RWE_KN	0
சாளம் என்பதன் பொருள் வஞ்சனை	சளம் என்பதன் பொருள் வஞ்சனை	RWE_KN	0
செல் என்பதன் பொருள் மீன்	சேல் என்பதன் பொருள் மீன்	RWE_KN	0
அங்கே சேல் 	அங்கே செல் 	RWE_KN	1
தலம் என்பதன் பொருள் பனை	தாலம் என்பதன் பொருள் பனை	RWE_KN	0
தலம் என்பதன் பொருள் கூந்தற்கமுகு	தாலம் என்பதன் பொருள் கூந்தற்கமுகு	RWE_KN	0
தலம் என்பதன் பொருள் கூந்தற்பனை	தாலம் என்பதன் பொருள் கூந்தற்பனை	RWE_KN	0
தலம் என்பதன் பொருள் பூமி	தாலம் என்பதன் பொருள் பூமி	RWE_KN	0
தாலம் என்பதன் பொருள் இடம்	தலம் என்பதன் பொருள் இடம்	RWE_KN	0
தாலம் என்பதன் பொருள் பூமி	தலம் என்பதன் பொருள் பூமி	RWE_KN	0
தாளம் என்பதன் பொருள் மேடை	தளம் என்பதன் பொருள் மேடை	RWE_KN	0
தாளம் என்பதன் பொருள் மாடி வீட்டின் அடுக்கு	தளம் என்பதன் பொருள் மாடி வீட்டின் அடுக்கு	RWE_KN	0
தளம் போடு 	தாளம் போடு 	RWE_KN	0
தாளி என்பதன் பொருள் நீர்த்துளி	தளி என்பதன் பொருள் நீர்த்துளி	RWE_KN	0
தாளி என்பதன் பொருள் முகில்	தளி என்பதன் பொருள் முகில்	RWE_KN	0
தளி என்பதன் பொருள் தாளித்தல்	தாளி என்பதன் பொருள் தாளித்தல்	RWE_KN	0
தளி என்பதன் பொருள் நாக்கு	தாளி என்பதன் பொருள் நாக்கு	RWE_KN	0
தளி என்பதன் பொருள் தாலாட்டு	தாளி என்பதன் பொருள் தாலாட்டு	RWE_KN	0
துலி என்பதன் பொருள் எழுதுகோல்	தூலி என்பதன் பொருள் எழுதுகோல்	RWE_KN	0
துலி என்பதன் பொருள் எழுத்தாணி	தூலி என்பதன் பொருள் எழுத்தாணி	RWE_KN	0
தூலி என்பதன் பொருள் பெண் ஆமை	துலி என்பதன் பொருள் பெண் ஆமை	RWE_KN	0
துளி என்பதன் பொருள் புழுதி	தூளி என்பதன் பொருள் புழுதி	RWE_KN	0
துளி என்பதன் பொருள் குதிரை	தூளி என்பதன் பொருள் குதிரை	RWE_KN	0
தூளி என்பதன் பொருள் மழைத்துளி	துளி என்பதன் பொருள் மழைத்துளி	RWE_KN	0
தூளி என்பதன் பொருள் திவலை	துளி என்பதன் பொருள் திவலை	RWE_KN	0
தூளி என்பதன் பொருள் சிறிய அளவு	துளி என்பதன் பொருள் சிறிய அளவு	RWE_KN	0
தோளி என்பதன் பொருள் வீதி	தொளி என்பதன் பொருள் வீதி	RWE_KN	0
தொளி என்பதன் பொருள் அவுரி, ஒருவகை குத்துச்செடி	தோளி என்பதன் பொருள் அவுரி, ஒருவகை குத்துச்செடி	RWE_KN	0
தொளி என்பதன் பொருள் அரக்கு	தோளி என்பதன் பொருள் அரக்கு	RWE_KN	0
தோலி என்பதன் பொருள் தோல்  	தொலி என்பதன் பொருள் தோல்  	RWE_KN	0
தோலி என்பதன் பொருள் உமி	தொலி என்பதன் பொருள் உமி	RWE_KN	0
தொலி என்பதன் பொருள் பிசின்	தோலி என்பதன் பொருள் பிசின்	RWE_KN	0
தொலி என்பதன் பொருள் ஒருவகை மீன்	தோலி என்பதன் பொருள் ஒருவகை மீன்	RWE_KN	0
தோல் என்பதன் பொருள் பழைய	தொல் என்பதன் பொருள் பழைய	RWE_KN	0
தொல் என்பதன் பொருள் சருமம்	தோல் என்பதன் பொருள் சருமம்	RWE_KN	0
தொல் என்பதன் பொருள் வனப்பு	தோல் என்பதன் பொருள் வனப்பு	RWE_KN	0
தொல் என்பதன் பொருள் விதையின் மேல்பகுதி	தோல் என்பதன் பொருள் விதையின் மேல்பகுதி	RWE_KN	0
நலி என்பதன் பொருள் கந்தைத்துணி	நாலி என்பதன் பொருள் கந்தைத்துணி	RWE_KN	0
நாலி என்பதன் பொருள் நோய்	நலி என்பதன் பொருள் நோய்	RWE_KN	0
நளி  என்பதன் பொருள் ஞாளி 	நாளி  என்பதன் பொருள் ஞாளி 	RWE_KN	0
நளி  என்பதன் பொருள் நாய்	நாளி  என்பதன் பொருள் நாய்	RWE_KN	0
நாளி என்பதன் பொருள் குளிர்ச்சி	நளி என்பதன் பொருள் குளிர்ச்சி	RWE_KN	0
நாளி என்பதன் பொருள் பெருமை	நளி என்பதன் பொருள் பெருமை	RWE_KN	0
நல்  என்பதன் பொருள் நான்கு 	நால்  என்பதன் பொருள் நான்கு 	RWE_KN	0
நால் என்பதன் பொருள் நல்ல	நல் என்பதன் பொருள் நல்ல	RWE_KN	0
நள் என்பதன் பொருள் தினம்	நாள்  என்பதன் பொருள் தினம்	RWE_KN	0
நாள் என்பதன் பொருள் இரவு	நள் என்பதன் பொருள் இரவு	RWE_KN	0
நாள் என்பதன் பொருள் நடு	நள் என்பதன் பொருள் நடு	RWE_KN	0
நாள் என்பதன் பொருள் நள்ளிரவு	நள் என்பதன் பொருள் நள்ளிரவு	RWE_KN	0
நாலம் என்பதன் பொருள் நன்மை	நலம் என்பதன் பொருள் நன்மை	RWE_KN	0
நாலம் என்பதன் பொருள் அழகு	நலம் என்பதன் பொருள் அழகு	RWE_KN	0
நாலம் என்பதன் பொருள் அன்பு	நலம் என்பதன் பொருள் அன்பு	RWE_KN	0
நலம் என்பதன் பொருள் பூவின் காம்பு	நாலம் என்பதன் பொருள் பூவின் காம்பு	RWE_KN	0
நாளம் என்பதன் பொருள் தாமரை	நளம் என்பதன் பொருள் தாமரை	RWE_KN	0
நளம் என்பதன் பொருள் பூந்தண்டு	நாளம் என்பதன் பொருள் பூந்தண்டு	RWE_KN	0
நளம் என்பதன் பொருள் உட்துளை	நாளம் என்பதன் பொருள் உட்துளை	RWE_KN	0
நளம் என்பதன் பொருள் ரத்தநாளம்	நாளம் என்பதன் பொருள் ரத்தநாளம்	RWE_KN	0
நீலம் என்பதன் பொருள் தரை	நிலம் என்பதன் பொருள் தரை	RWE_KN	0
நீலம் என்பதன் பொருள் பூமி	நிலம் என்பதன் பொருள் பூமி	RWE_KN	0
நிலம் என்பதன் பொருள் ஒரு நிறம்	நீலம் என்பதன் பொருள் ஒரு நிறம்	RWE_KN	0
நிலம் என்பதன் பொருள் கருங்குவளை	நீலம் என்பதன் பொருள் கருங்குவளை	RWE_KN	0
நிலம் என்பதன் பொருள் இருள்	நீலம் என்பதன் பொருள் இருள்	RWE_KN	0
நீல் என்பதன் பொருள் கால்கள் ஊன்ற உடல் நிமிர்ந்திருத்தல்	நில் என்பதன் பொருள் கால்கள் ஊன்ற உடல் நிமிர்ந்திருத்தல்	RWE_KN	0
நில் என்பதன் பொருள் நீலம்	நீல் என்பதன் பொருள் நீலம்	RWE_KN	0
நில் என்பதன் பொருள் காற்று	நீல் என்பதன் பொருள் காற்று	RWE_KN	0
பலி என்பதன் பொருள் ஆலமரம்	பாலி என்பதன் பொருள் ஆலமரம்	RWE_KN	0
பலி என்பதன் பொருள் பருத்தி	பாலி என்பதன் பொருள் பருத்தி	RWE_KN	0
பலி என்பதன் பொருள் கள்	பாலி என்பதன் பொருள் கள்	RWE_KN	0
பாலி என்பதன் பொருள் பலியிடுதல்	பலி என்பதன் பொருள் பலியிடுதல்	RWE_KN	0
பாலி என்பதன் பொருள் பலியுயிர்	பலி என்பதன் பொருள் பலியுயிர்	RWE_KN	0
பழி  என்பதன் பொருள்	பாழி  என்பதன் பொருள்	RWE_KN	0
பழி  என்பதன் பொருள் வெறுமை	பாழி  என்பதன் பொருள் வெறுமை	RWE_KN	0
பழி  என்பதன் பொருள் ஆகாயம்	பாழி  என்பதன் பொருள் ஆகாயம்	RWE_KN	0
பழி  என்பதன் பொருள் கடல்	பாழி  என்பதன் பொருள் கடல்	RWE_KN	0
பழி  என்பதன் பொருள் பெருமை	பாழி  என்பதன் பொருள் பெருமை	RWE_KN	0
பழி  என்பதன் பொருள் வலிமை	பாழி  என்பதன் பொருள் வலிமை	RWE_KN	0
பாழி என்பதன் பொருள் குற்றம்	பழி என்பதன் பொருள் குற்றம்	RWE_KN	0
பிழை என்பதன் பொருள் துன்பம்	பீழை என்பதன் பொருள் துன்பம்	RWE_KN	0
பீழை என்பதன் பொருள் குற்றம்	பிழை என்பதன் பொருள் குற்றம்	RWE_KN	0
பீழை என்பதன் பொருள் தவறு	பிழை என்பதன் பொருள் தவறு	RWE_KN	0
பூலம் என்பதன் பொருள் இடம்	புலம் என்பதன் பொருள் இடம்	RWE_KN	0
புலம் என்பதன் பொருள் புற்கட்டு	பூலம் என்பதன் பொருள் புற்கட்டு	RWE_KN	0
போலி என்பதன் பொருள் செழித்தல்	பொலி என்பதன் பொருள் செழித்தல்	RWE_KN	0
போலி என்பதன் பொருள் மங்கலமாதல்	பொலி என்பதன் பொருள் மங்கலமாதல்	RWE_KN	0
பொலி என்பதன் பொருள் பொய்	போலி என்பதன் பொருள் பொய்	RWE_KN	0
பொலி என்பதன் பொருள் வஞ்சகம்	போலி என்பதன் பொருள் வஞ்சகம்	RWE_KN	0
பொலி என்பதன் பொருள் ஒப்பு	போலி என்பதன் பொருள் ஒப்பு	RWE_KN	0
மாலை என்பதன் பொருள் குன்று	மலை என்பதன் பொருள் குன்று	RWE_KN	0
மாலை என்பதன் பொருள் பொருப்பு	மலை என்பதன் பொருள் பொருப்பு	RWE_KN	0
மாலை என்பதன் பொருள் வெற்பு	மலை என்பதன் பொருள் வெற்பு	RWE_KN	0
மாலை என்பதன் பொருள் சிகரம்	மலை என்பதன் பொருள் சிகரம்	RWE_KN	0
மலை என்பதன் பொருள் அந்திப்பொழுது	மாலை என்பதன் பொருள் அந்திப்பொழுது	RWE_KN	0
மலை என்பதன் பொருள் பூமாலை	மாலை என்பதன் பொருள் பூமாலை	RWE_KN	0
மாழை என்பதன் பொருள் மழைநீர்	மழை என்பதன் பொருள் மழைநீர்	RWE_KN	0
மாழை என்பதன் பொருள் குளிர்ச்சி	மழை என்பதன் பொருள் குளிர்ச்சி	RWE_KN	0
மாழை என்பதன் பொருள் மேகம்	மழை என்பதன் பொருள் மேகம்	RWE_KN	0
மழை என்பதன் பொருள் மயக்கம்	மாழை என்பதன் பொருள் மயக்கம்	RWE_KN	0
மழை என்பதன் பொருள் மயக்கம்	மாழை என்பதன் பொருள் மயக்கம்	RWE_KN	0
மழை என்பதன் பொருள் இளமை	மாழை என்பதன் பொருள் இளமை	RWE_KN	0
மழை என்பதன் பொருள் இளமை	மாழை என்பதன் பொருள் இளமை	RWE_KN	0
மழை என்பதன் பொருள் அழகு	மாழை என்பதன் பொருள் அழகு	RWE_KN	0
மழை என்பதன் பொருள் அழகு	மாழை என்பதன் பொருள் அழகு	RWE_KN	0
மூலை என்பதன் பொருள் உடலிலுள்ள ஓர் உறுப்பு	முலை என்பதன் பொருள் உடலிலுள்ள ஓர் உறுப்பு	RWE_KN	0
முலை என்பதன் பொருள் இரு கோடுகள் சந்திக்கும் இடம்	மூலை என்பதன் பொருள் இரு கோடுகள் சந்திக்கும் இடம்	RWE_KN	0
மூளை என்பதன் பொருள் முளைத்தல்	முளை என்பதன் பொருள் முளைத்தல்	RWE_KN	0
மூளை என்பதன் பொருள் தறி	முளை என்பதன் பொருள் தறி	RWE_KN	0
மூளை என்பதன் பொருள் ஆப்பு	முளை என்பதன் பொருள் ஆப்பு	RWE_KN	0
மூளை என்பதன் பொருள் அங்குசம் 	முளை என்பதன் பொருள் அங்குசம் 	RWE_KN	0
மூளை என்பதன் பொருள் இளமை	முளை என்பதன் பொருள் இளமை	RWE_KN	0
மூளை என்பதன் பொருள் தண்டு	முளை என்பதன் பொருள் தண்டு	RWE_KN	0
மூளை என்பதன் பொருள் மூங்கில்	முளை என்பதன் பொருள் மூங்கில்	RWE_KN	0
முளை என்பதன் பொருள் மண்டைக்குள் இருக்கும் ஓர் உறுப்பு	மூளை என்பதன் பொருள் மண்டைக்குள் இருக்கும் ஓர் உறுப்பு	RWE_KN	0
விழா என்பதன் பொருள் திருவிழா	விழா என்பதன் பொருள் திருவிழா	RWE_KN	0
விலாங்கு என்பதன் பொருள் பூட்டு	விலங்கு என்பதன் பொருள் பூட்டு	RWE_KN	0
விலாங்கு என்பதன் பொருள் கை	விலங்கு என்பதன் பொருள் கை	RWE_KN	0
விலாங்கு என்பதன் பொருள் கைகளைப் பிணிக்கும் கருவி	விலங்கு என்பதன் பொருள் கைகளைப் பிணிக்கும் கருவி	RWE_KN	0
விலாங்கு என்பதன் பொருள் மிருகம்	விலங்கு என்பதன் பொருள் மிருகம்	RWE_KN	0
விலங்கு ஒரு மீன் வகை	விலாங்கு ஒரு மீன் வகை	RWE_KN	0
ஆரம் என்பதன் பொருள் ஒரு கருவி	அரம் என்பதன் பொருள் ஒரு கருவி	RWE_KN	0
அரம் என்பதன் பொருள் மாலை 	ஆரம் என்பதன் பொருள் மாலை 	RWE_KN	0
ஆரி என்பதன் பொருள் திருமால்	அரி என்பதன் பொருள் திருமால்	RWE_KN	0
ஆரி என்பதன் பொருள் அரிசி	அரி என்பதன் பொருள் அரிசி	RWE_KN	0
ஆரி என்பதன் பொருள் அழகு	அரி என்பதன் பொருள் அழகு	RWE_KN	0
ஆரி என்பதன் பொருள் அரிதல்	அரி என்பதன் பொருள் அரிதல்	RWE_KN	0
ஆரி என்பதன் பொருள் பன்றி	அரி என்பதன் பொருள் பன்றி	RWE_KN	0
ஆரி என்பதன் பொருள் வண்டு	அரி என்பதன் பொருள் வண்டு	RWE_KN	0
ஆரி என்பதன் பொருள் கடல்	அரி என்பதன் பொருள் கடல்	RWE_KN	0
ஆரி என்பதன் பொருள் தகடு	அரி என்பதன் பொருள் தகடு	RWE_KN	0
ஆரி என்பதன் பொருள் சிவன்	அரி என்பதன் பொருள் சிவன்	RWE_KN	0
ஆரி என்பதன் பொருள் சிங்கம்	அரி என்பதன் பொருள் சிங்கம்	RWE_KN	0
அரி என்பதன் பொருள் அருமை	ஆரி என்பதன் பொருள் அருமை	RWE_KN	0
அரி என்பதன் பொருள் மேன்மை	ஆரி என்பதன் பொருள் மேன்மை	RWE_KN	0
அரி என்பதன் பொருள் அழகு	ஆரி என்பதன் பொருள் அழகு	RWE_KN	0
ஆரு என்பதன் பொருள் உருவமற்றது	அரு என்பதன் பொருள் உருவமற்றது	RWE_KN	0
அரு என்பதன் பொருள் குடம்	ஆரு என்பதன் பொருள் குடம்	RWE_KN	0
அரு என்பதன் பொருள் நண்டு	ஆரு என்பதன் பொருள் நண்டு	RWE_KN	0
ஆறு என்பதன் பொருள் துண்டித்து விடு	அறு என்பதன் பொருள் துண்டித்து விடு	RWE_KN	0
ஆறு என்பதன் பொருள் அறுத்து விடு	அறு என்பதன் பொருள் அறுத்து விடு	RWE_KN	0
அறு என்பதன் பொருள் ஒரு எண்	ஆறு என்பதன் பொருள் ஒரு எண்	RWE_KN	0
அறு என்பதன் பொருள் வழி	ஆறு என்பதன் பொருள் வழி	RWE_KN	0
அறு என்பதன் பொருள் சமயம்	ஆறு என்பதன் பொருள் சமயம்	RWE_KN	0
அறு என்பதன் பொருள் தன்மை	ஆறு என்பதன் பொருள் தன்மை	RWE_KN	0
அறு என்பதன் பொருள் நதி	ஆறு என்பதன் பொருள் நதி	RWE_KN	0
அறு என்பதன் பொருள் ஒழுக்கம்	ஆறு என்பதன் பொருள் ஒழுக்கம்	RWE_KN	0
அறு என்பதன் பொருள் பக்கம்	ஆறு என்பதன் பொருள் பக்கம்	RWE_KN	0
அறு என்பதன் பொருள் நிலை	ஆறு என்பதன் பொருள் நிலை	RWE_KN	0
ஆர என்பதன் பொருள் பாம்பு	அர என்பதன் பொருள் பாம்பு	RWE_KN	0
அர என்பதன் பொருள் நிறைய	ஆர என்பதன் பொருள் நிறைய	RWE_KN	0
அர என்பதன் பொருள் அனுபவிக்க	ஆர என்பதன் பொருள் அனுபவிக்க	RWE_KN	0
ஆற என்பதன் பொருள் தெளிய	அற என்பதன் பொருள் தெளிய	RWE_KN	0
ஆற என்பதன் பொருள் முற்றுமாக	அற என்பதன் பொருள் முற்றுமாக	RWE_KN	0
அற என்பதன் பொருள் சூடு குறைய	ஆற என்பதன் பொருள் சூடு குறைய	RWE_KN	0
இறு என்பதன் பொருள் அந்தம்	ஈறு என்பதன் பொருள் அந்தம்	RWE_KN	0
இறு என்பதன் பொருள் மரணம் 	ஈறு என்பதன் பொருள் மரணம் 	RWE_KN	0
இறு என்பதன் பொருள் எல்லை	ஈறு என்பதன் பொருள் எல்லை	RWE_KN	0
ஈறு என்பதன் பொருள் ஒடி	இறு என்பதன் பொருள் ஒடி	RWE_KN	0
ஈறு என்பதன் பொருள் கெடு	இறு என்பதன் பொருள் கெடு	RWE_KN	0
ஈறு என்பதன் பொருள் சொல்லு	இறு என்பதன் பொருள் சொல்லு	RWE_KN	0
உரு என்பதன் பொருள் தொடை	ஊரு என்பதன் பொருள் தொடை	RWE_KN	0
ஊரு என்பதன் பொருள் வடிவம்	உரு என்பதன் பொருள் வடிவம்	RWE_KN	0
ஊரு என்பதன் பொருள் அழகு	உரு என்பதன் பொருள் அழகு	RWE_KN	0
ஊரு என்பதன் பொருள் உடல்	உரு என்பதன் பொருள் உடல்	RWE_KN	0
ஊரு என்பதன் பொருள் மரக்கலம்	உரு என்பதன் பொருள் மரக்கலம்	RWE_KN	0
ஊரு என்பதன் பொருள் நிறம்	உரு என்பதன் பொருள் நிறம்	RWE_KN	0
ஊரு என்பதன் பொருள் அச்சம்	உரு என்பதன் பொருள் அச்சம்	RWE_KN	0
ஊரு என்பதன் பொருள் பெருமை	உரு என்பதன் பொருள் பெருமை	RWE_KN	0
ஊரு என்பதன் பொருள் மேன்மை	உரு என்பதன் பொருள் மேன்மை	RWE_KN	0
ஊறு என்பதன் பொருள் மிகுதி	உறு என்பதன் பொருள் மிகுதி	RWE_KN	0
உறு என்பதன் பொருள் துன்பம் 	ஊறு என்பதன் பொருள் துன்பம் 	RWE_KN	0
உறு என்பதன் பொருள் கொலை	ஊறு என்பதன் பொருள் கொலை	RWE_KN	0
உறு என்பதன் பொருள் காயம் உறுதல்	ஊறு என்பதன் பொருள் காயம் உறுதல்	RWE_KN	0
உறு என்பதன் பொருள் தீண்டல்	ஊறு என்பதன் பொருள் தீண்டல்	RWE_KN	0
உறு என்பதன் பொருள் குற்றம்	ஊறு என்பதன் பொருள் குற்றம்	RWE_KN	0
உறு என்பதன் பொருள் புண்	ஊறு என்பதன் பொருள் புண்	RWE_KN	0
உறு என்பதன் பொருள் கொலை	ஊறு என்பதன் பொருள் கொலை	RWE_KN	0
ஏரி என்பதன் பொருள் தீ	எரி என்பதன் பொருள் தீ	RWE_KN	0
ஏரி என்பதன் பொருள் கார்த்திகை	எரி என்பதன் பொருள் கார்த்திகை	RWE_KN	0
ஏரி என்பதன் பொருள் பிரபை	எரி என்பதன் பொருள் பிரபை	RWE_KN	0
ஏரி என்பதன் பொருள் இடபராசி	எரி என்பதன் பொருள் இடபராசி	RWE_KN	0
ஏரி என்பதன் பொருள் நெருப்பு	எரி என்பதன் பொருள் நெருப்பு	RWE_KN	0
ஏரி என்பதன் பொருள் நரகம்	எரி என்பதன் பொருள் நரகம்	RWE_KN	0
ஏரி என்பதன் பொருள் வெம்மை	எரி என்பதன் பொருள் வெம்மை	RWE_KN	0
ஏரி என்பதன் பொருள் கந்தகம்	எரி என்பதன் பொருள் கந்தகம்	RWE_KN	0
எரி என்பதன் பொருள் நீர்நிலை	ஏரி என்பதன் பொருள் நீர்நிலை	RWE_KN	0
எரி என்பதன் பொருள் குளம்	ஏரி என்பதன் பொருள் குளம்	RWE_KN	0
ஏறி என்பதன் பொருள் விடுதல்	எறி என்பதன் பொருள் விடுதல்	RWE_KN	0
ஏறி என்பதன் பொருள் எறிதல்	எறி என்பதன் பொருள் எறிதல்	RWE_KN	0
ஏறி என்பதன் பொருள் குறிப்பாகக் கூறுதல்	எறி என்பதன் பொருள் குறிப்பாகக் கூறுதல்	RWE_KN	0
எறி என்பதன் பொருள் உயர்ந்த	ஏறி என்பதன் பொருள் உயர்ந்த	RWE_KN	0
எறி என்பதன் பொருள் மேலே ஏறி	ஏறி என்பதன் பொருள் மேலே ஏறி	RWE_KN	0
கரம் என்பதன் பொருள் உறைப்பு	காரம் என்பதன் பொருள் உறைப்பு	RWE_KN	0
கரம் என்பதன் பொருள் சாம்பலுப்பு	காரம் என்பதன் பொருள் சாம்பலுப்பு	RWE_KN	0
கரம் என்பதன் பொருள் அழிவு	காரம் என்பதன் பொருள் அழிவு	RWE_KN	0
காரம் என்பதன் பொருள் கிரணம்	கரம் என்பதன் பொருள் கிரணம்	RWE_KN	0
காரம் என்பதன் பொருள் விஷம்	கரம் என்பதன் பொருள் விஷம்	RWE_KN	0
காரம் என்பதன் பொருள் செயல்	கரம் என்பதன் பொருள் செயல்	RWE_KN	0
காரம் என்பதன் பொருள் கை	கரம் என்பதன் பொருள் கை	RWE_KN	0
காரம் என்பதன் பொருள் கழுதை	கரம் என்பதன் பொருள் கழுதை	RWE_KN	0
வாரம் என்பதன் பொருள் தெய்வம் முதலியவற்றால் பெறும் பேறு	வரம் என்பதன் பொருள் தெய்வம் முதலியவற்றால் பெறும் பேறு	RWE_KN	0
வாரம் என்பதன் பொருள் அனுக்கிரகம்	வரம் என்பதன் பொருள் அனுக்கிரகம்	RWE_KN	0
வாரம் என்பதன் பொருள் ஆசீர்வாதம்	வரம் என்பதன் பொருள் ஆசீர்வாதம்	RWE_KN	0
வரம் என்பதன் பொருள் ஏழு கிழமைகள்	வாரம் என்பதன் பொருள் ஏழு கிழமைகள்	RWE_KN	0
வரம் என்பதன் பொருள் தூண்	வாரம் என்பதன் பொருள் தூண்	RWE_KN	0
வரம் என்பதன் பொருள் வரம்பு	வாரம் என்பதன் பொருள் வரம்பு	RWE_KN	0
மரம் என்பதன் பொருள் கோடகசாலை	மாரம் என்பதன் பொருள் கோடகசாலை	RWE_KN	0
மாரம் என்பதன் பொருள் தாவரம்	மரம் என்பதன் பொருள் தாவரம்	RWE_KN	0
மாரம் என்பதன் பொருள் அறுக்கப்பட்ட மரம்	மரம் என்பதன் பொருள் அறுக்கப்பட்ட மரம்	RWE_KN	0
பாரம் என்பதன் பொருள் திருமால் நிலை ஐந்தனுள் ஒன்று 	பரம் என்பதன் பொருள் திருமால் நிலை ஐந்தனுள் ஒன்று 	RWE_KN	0
பாரம் என்பதன் பொருள் கடவுள்	பரம் என்பதன் பொருள் கடவுள்	RWE_KN	0
பாரம் என்பதன் பொருள் மோட்சம்	பரம் என்பதன் பொருள் மோட்சம்	RWE_KN	0
பரம் என்பதன் பொருள் சுமை	பாரம் என்பதன் பொருள் சுமை	RWE_KN	0
பரம் என்பதன் பொருள் கனம்	பாரம் என்பதன் பொருள் கனம்	RWE_KN	0
பரம் என்பதன் பொருள் பெருங்குடும்பம்	பாரம் என்பதன் பொருள் பெருங்குடும்பம்	RWE_KN	0
நூலைத் தோடு  	நூலைத் தேடு 	RWE_KN	1
தேடு அணிந்தாள் 	தோடு அணிந்தாள் 	RWE_KN	0
உடல்நலக் கோடு 	உடல்நலக் கேடு 	RWE_KN	1
உடல்நலக் கெடு 	உடல்நலக் கேடு 	RWE_KN	1
கேடு போட்டாள் 	கோடு போட்டாள் 	RWE_KN	0
கொண்டைக் கால் 	கெண்டைக் கால் 	RWE_KN	0
கொண்டை மீன் 	கெண்டை மீன் 	RWE_KN	0
கெண்டை மேல் பூ வைத்தாள் 	கொண்டை மேல் பூ வைத்தாள் 	RWE_KN	0
கெண்டைக் கடலை	கொண்டைக் கடலை	RWE_KN	0
உணவைக் கொடு 	உணவைக் கெடு 	RWE_KN	1
அவனுக்குக் கெடு 	அவனுக்குக் கொடு 	RWE_KN	1