அறம் ஒரு கருவி   	அரம் ஒரு கருவி   
அரம் என்றால் தருமம் 	அறம் என்றால் தருமம் 
புடலையை அறி	புடலையை அரி
அரிதல் என்றால் தெரிந்து கொள்ளுதல் 	அறிதல் என்றால் தெரிந்து கொள்ளுதல் 
அறுகு என்றால் அண்மை 	அருகு என்றால் அண்மை 
அருகு என்றால் அறுகம்புல் 	அறுகு என்றால் அறுகம்புல் 
அறை என்பதன் பொருள் பாதி	அரை என்பதன் பொருள் பாதி
எந்த அரையில் தங்கினாய்?	எந்த அறையில் தங்கினாய்?
இறத்தல் என்றால் பிச்சை எடுத்தல் 	இரத்தல் என்றால் பிச்சை எடுத்தல் 
இரத்தல் என்றால் சாதல் 	இறத்தல் என்றால் சாதல் 
உறவு என்றால் வலிமை 	உரவு என்றால் வலிமை 
உரவின்முறை 	உறவின்முறை 
தோலை உறி	தோலை உரி
கட்டித் தொங்க விடும் உரி 	கட்டித் தொங்க விடும் உறி
உறிஞ்சல் என்றால் உராய்தல் 	உரிஞ்சல் என்றால் உராய்தல் 
உரிஞ்சல் என்றால் உறிஞ்சிக் குடித்தல் 	உறிஞ்சல் என்றால் உறிஞ்சிக் குடித்தல் 
உறை என்றால் சொல்	உரை என்றால் சொல்
தலையணை உரை 	தலையணை உறை 
எறி என்றால் கொளுத்து 	எரி என்றால் கொளுத்து 
எரி என்றால் தூக்கி வீசு 	எறி என்றால் தூக்கி வீசு 
கற என்றால் மறை 	கர என்றால் மறை 
பால் கர 	பால் கற 
குளத்தின் கறை 	குளத்தின் கரை 
துணியில் கரை உள்ளது 	துணியில் கறை உள்ளது 
குறங்கு தாவியது 	குரங்கு தாவியது 
குரங்கு என்றால் தொடை 	குறங்கு என்றால் தொடை 
குறவை ஒரு வகைக் கூத்து 	குரவை ஒரு வகைக் கூத்து 
குரவை ஒரு வகை மீன் 	குறவை ஒரு வகை மீன் 
நாய் குறைத்தது 	நாய் குரைத்தது 
எடை குரைந்தது 	எடை குறைந்தது 
வீட்டின் கூறை	வீட்டின் கூரை 
கூரை என்றால் துணி 	கூறை என்றால் துணி 
செறித்தல் என்றால் செரிமானம் ஆதல் 	செரித்தல் என்றால் செரிமானம் ஆதல் 
செரித்தல் என்றால் திணித்தல் 	செறித்தல் என்றால் திணித்தல் 
பூச்சொறி	பூச்சொரி
காலைச் சொரியாதே!  	காலைச் சொறியாதே!  
திறை என்றால் அலை 	திரை என்றால் அலை 
திரை என்றால் வரி 	திறை என்றால் வரி 
தலைமுடி நறைத்தது 	தலைமுடி நரைத்தது 
நரை என்றால் தேன் 	நறை என்றால் தேன் 
நிறை என்றால் வரிசை 	நிரை என்றால் வரிசை 
பானையை நீரால் நிரைத்து விடு	பானையை நீரால் நிறைத்து விடு
பறவை என்றால் கடல் 	பரவை என்றால் கடல் 
குயில் ஒரு பரவை 	குயில் ஒரு பறவை 
பறி என்றால் குதிரை 	பரி என்றால் குதிரை 
பரித்தல் என்றால் பிடுங்கிக் கொள்ளுதல் 	பறித்தல் என்றால் பிடுங்கிக் கொள்ளுதல் 
கடப்பாறை எடு 	கடப்பாரை எடு 
பாரை மேல் அமர்ந்தான் 	பாறை மேல் அமர்ந்தான் 
பிரை நிலா 	பிறை நிலா 
பிறை என்றால் உறைமோர் 	பிரை என்றால் உறைமோர் 
சோளப் பொறி 	சோளப் பொரி 
பொரி என்றால் இயந்திரம் 	பொறி என்றால் இயந்திரம் 
காசைப் பொருக்கினான் 	காசைப் பொறுக்கினான் 
பொறுக்கு என்றால் பருக்கை 	பொருக்கு என்றால் பருக்கை 
மரம் என்றால் வீரம் 	மறம் என்றால் வீரம் 
மரம் என்றால் பாவம்  	மறம் என்றால் பாவம்  
பனை மறம்  	பனை மரம்  
மறி என்றால் சாகாமை 	மரி என்றால் சாகாமை 
சாலை மரியல் 	சாலை மறியல் 
மறை என்றால் மான் 	மரை என்றால் மான் 
உண்மையை மரைத்தான் 	உண்மையை மறைத்தான் 
முறுக்கு ஒரு மரம் 	முருக்கு ஒரு மரம் 
மீசையை முருக்கு 	மீசையை முறுக்கு 
விறகு என்றால் தந்திரம் 	விரகு என்றால் தந்திரம் 
விரகுக் கட்டை 	விறகுக் கட்டை 
விரல் என்றால் வெற்றி என்று பொருள் 	விறல் என்றால் வெற்றி என்று பொருள் 
கையில் விறல்கள் உள்ளன 	கையில் விரல்கள் உள்ளன 
அழகு என்பது அளவு 	அலகு என்பது அளவு 
அளகு என்பது அளவு 	அலகு என்பது அளவு 
அலகு ஒரு பறவை 	அளகு ஒரு பறவை 
அழகு ஒரு பறவை 	அளகு ஒரு பறவை 
வானவில் அலகாக இருந்தது 	வானவில் அழகாக இருந்தது 
வானவில் அளகாக இருந்தது 	வானவில் அழகாக இருந்தது 
பரிசு அலித்தான் 	பரிசு அளித்தான் 
பரிசு அழித்தான் 	பரிசு அளித்தான் 
கொன்று அலித்தான் 	கொன்று அழித்தான் 
கொன்று அளித்தான் 	கொன்று அழித்தான் 
முகமது அழி 	முகமது அலி 
முகமது அளி 	முகமது அலி 
அளைகடல் 	அலைகடல் 
அழைகடல் 	அலைகடல் 
தொலைபேசியில் அளைத்தான் 	தொலைபேசியில் அழைத்தான் 
தொலைபேசியில் அலைத்தான் 	தொலைபேசியில் அழைத்தான் 
அலை என்றால் வளை என்று பொருள் 	அளை என்றால் வளை என்று பொருள் 
அழை என்றால் வளை என்று பொருள் 	அளை என்றால் வளை என்று பொருள் 
வேலை ஆல் 	வேலை ஆள் 
வேலை ஆழ் 	வேலை ஆள் 
ஆல் மனம் 	ஆழ் மனம் 
ஆள் மனம் 	ஆழ் மனம் 
ஆழ் கிளை	ஆல் கிளை
ஆள் கிளை	ஆல் கிளை
தாமரை இளை 	தாமரை இலை 
தாமரை இழை 	தாமரை இலை 
இலைத்தல் இகழ்ச்சி 	இளைத்தல் இகழ்ச்சி 
இழைத்தல் இகழ்ச்சி 	இளைத்தல் இகழ்ச்சி 
இலை என்பது மெல்லிய நூல் 	இழை என்பது மெல்லிய நூல் 
இளை என்பது மெல்லிய நூல் 	இழை என்பது மெல்லிய நூல் 
நிலத்தில் உலவு செய்யலாம் 	நிலத்தில் உழவு செய்யலாம் 
நிலத்தில் உளவு செய்யலாம் 	நிலத்தில் உழவு செய்யலாம் 
ஒற்றன் உலவு பார்த்தான் 	ஒற்றன் உளவு பார்த்தான் 
ஒற்றன் உழவு பார்த்தான் 	ஒற்றன் உளவு பார்த்தான் 
ஆற்றங்கரையில் உளவினேன் 	ஆற்றங்கரையில் உலவினேன் 
ஆற்றங்கரையில் உழவினேன் 	ஆற்றங்கரையில் உலவினேன் 
ஒளி என்றால் சத்தம் 	ஒலி என்றால் சத்தம் 
ஒழி என்றால் சத்தம் 	ஒலி என்றால் சத்தம் 
ஒலி என்றால் வெளிச்சம் 	ஒளி என்றால் வெளிச்சம் 
ஒழி என்றால் வெளிச்சம் 	ஒளி என்றால் வெளிச்சம் 
ஒலி  என்பது அழித்தல் 	ஒழி என்பது அழித்தல் 
ஒளி என்பது அழித்தல் 	ஒழி என்பது அழித்தல் 
களி என்றால் பஞ்சம் 	கலி என்றால் பஞ்சம் 
கழி என்றால் பஞ்சம் 	கலி என்றால் பஞ்சம் 
கலி என்பதன் பொருள்  மகிழ்தல் 	களி என்பதன் பொருள்  மகிழ்தல் 
கழி என்பதன் பொருள்  மகிழ்தல் 	களி என்பதன் பொருள்  மகிழ்தல் 
கலி என்றால் உப்பளம் 	கழி என்றால் உப்பளம் 
களி என்றால் உப்பளம் 	கழி என்றால் உப்பளம் 
களை என்பதன் பொருள் மூங்கில் 	கழை என்பதன் பொருள் மூங்கில் 
கலை என்பதன் பொருள் மூங்கில் 	கழை என்பதன் பொருள் மூங்கில் 
நடனக் களை	நடனக் கலை
நடனக் கழை	நடனக் கலை
கலை பறித்தாள் 	களை பறித்தாள் 
கழை பறித்தாள் 	களை பறித்தாள் 
கிலி ஒரு பறவை 	கிளி ஒரு பறவை 
கிழி ஒரு பறவை 	கிளி ஒரு பறவை 
தாளைக் கிலி 	தாளைக் கிழி 
தாளைக் கிளி 	தாளைக் கிழி 
கிளி என்பதன் பொருள் பயம் 	கிலி என்பதன் பொருள் பயம் 
கிழி என்பதன் பொருள் பயம் 	கிலி என்பதன் பொருள் பயம் 
படை சூலப் புறப்பட்டான் 	படை சூழப் புறப்பட்டான் 
படை சூளப் புறப்பட்டான் 	படை சூழப் புறப்பட்டான் 
சூல் என்பதன் பொருள் சபதம் 	சூள் என்பதன் பொருள் சபதம் 
சூழ் என்பதன் பொருள் சபதம் 	சூள் என்பதன் பொருள் சபதம் 
சூள் என்பதன் பொருள் கருப்பம் 	சூல் என்பதன் பொருள் கருப்பம் 
சூழ் என்பதன் பொருள் கருப்பம் 	சூல் என்பதன் பொருள் கருப்பம் 
தளையில் தொப்பி வைத்தான் 	தலையில் தொப்பி வைத்தான் 
தழையில் தொப்பி வைத்தான் 	தலையில் தொப்பி வைத்தான் 
தழை என்பதன் பொருள் கட்டு 	தளை என்பதன் பொருள் கட்டு 
தலை என்பதன் பொருள் கட்டு 	தளை என்பதன் பொருள் கட்டு 
தளை என்பதன் பொருள் தளிர் 	தழை என்பதன் பொருள் தளிர் 
தலை என்பதன் பொருள் தளிர் 	தழை என்பதன் பொருள் தளிர் 
வளியில் துடித்தாள் 	வலியில் துடித்தாள் 
வழியில் துடித்தாள் 	வலியில் துடித்தாள் 
வலி என்பதன் பொருள் காற்று 	வளி என்பதன் பொருள் காற்று 
வழி என்பதன் பொருள் காற்று 	வளி என்பதன் பொருள் காற்று 
கிராமம் செல்லும் வலி	கிராமம் செல்லும் வழி 
கிராமம் செல்லும் வளி 	கிராமம் செல்லும் வழி 
வளையில் மீன் சிக்கியது 	வலையில் மீன் சிக்கியது 
வழையில் மீன் சிக்கியது 	வலையில் மீன் சிக்கியது 
வளை ஒரு மரம் 	வழை ஒரு மரம் 
வலை ஒரு மரம் 	வழை ஒரு மரம் 
கண்ணாடி வலையல் 	கண்ணாடி வளையல் 
கண்ணாடி வழையல் 	கண்ணாடி வளையல் 
நாய் வாள்	நாய் வால்
நாய் வாழ்	நாய் வால்
நலமாக வால் 	நலமாக வாழ் 
நலமாக வாள் 	நலமாக வாழ் 
வால் கூர்மையாக இருந்தது 	வாள் கூர்மையாக இருந்தது 
வாழ் கூர்மையாக இருந்தது 	வாள் கூர்மையாக இருந்தது 
விலாக்காலம் 	விழாக்காலம் 
விளாக்காலம் 	விழாக்காலம் 
விலா ஒரு மரம் 	விளா ஒரு மரம் 
விழா ஒரு மரம் 	விளா ஒரு மரம் 
விழாவெலும்பு	விலாவெலும்பு
விளாவெலும்பு	விலாவெலும்பு
விளைவாசி உயர்வு 	விலைவாசி உயர்வு 
விழைவாசி உயர்வு 	விலைவாசி உயர்வு 
கரும்பு விலைந்தது 	கரும்பு விளைந்தது 
கரும்பு விழைந்தது 	கரும்பு விளைந்தது 
விலை என்பதன் பொருள் விரும்புதல் 	விழை என்பதன் பொருள் விரும்புதல் 
விளை என்பதன் பொருள் விரும்புதல் 	விழை என்பதன் பொருள் விரும்புதல் 
அன்னாய் கடிக்கும் 	அந்நாய் கடிக்கும் 
அந்நாய் என வணங்கினான் 	அன்னாய் என வணங்கினான் 
இன்னகை என்பதன் பொருள் இந்த நகை 	இந்நகை என்பதன் பொருள் இந்த நகை 
இந்நகை என்பதன் பொருள் இனிய நகைப்பு 	இன்னகை என்பதன் பொருள் இனிய நகைப்பு 
இன்னா என்பதன் பொருள் இந்த நாக்கு 	இந்நா என்பதன் பொருள் இந்த நாக்கு 
இந்நா என்பதன் பொருள் தீயவை 	இன்னா என்பதன் பொருள் தீயவை 
இன்னிலை என்பதன் பொருள் இந்த நிலை 	இந்நிலை என்பதன் பொருள் இந்த நிலை 
இந்நிலை என்பதன் பொருள் இனிய நிலை 	இன்னிலை என்பதன் பொருள் இனிய நிலை 
இன்னீர் என்பதன் பொருள் இந்த நீர் 	இந்நீர் என்பதன் பொருள் இந்த நீர் 
இந்நீர் என்பதன் பொருள் இனிய தன்மை  	இன்னீர் என்பதன் பொருள் இனிய தன்மை  
சென்னாய் ஒரு வகை நாய் 	செந்நாய் ஒரு வகை நாய் 
செந்நாய் என்பதன் பொருள் போகின்ற நாய் 	சென்னாய் என்பதன் பொருள் போகின்ற நாய் 
தேனீர் என்பதன் பொருள் தேயிலை நீர் 	தேநீர் என்பதன் பொருள் தேயிலை நீர் 
தேநீர் என்பதன் பொருள் தேன் கலந்த நீர் 	தேனீர் என்பதன் பொருள் தேன் கலந்த நீர் 
நன்னூல் என்பதன் பொருள் நம் நூல் 	நந்நூல் என்பதன் பொருள் நம் நூல் 
நந்நூல் என்பதன் நல்ல நூல் 	நன்னூல் என்பதன் நல்ல நூல் 
முன்னாள் என்பதன் பொருள் மூன்று நாட்கள் 	முந்நாள் என்பதன் பொருள் மூன்று நாட்கள் 
முந்நாள் என்பதன் பொருள் முன்னைய நாள் 	முன்னாள் என்பதன் பொருள் முன்னைய நாள் 
வென்னீர் என்பதன் பொருள் வெம்மையான நீர் 	வெந்நீர் என்பதன் பொருள் வெம்மையான நீர் 
வெந்நீர் என்பதன் பொருள் வெல்லும் தன்மை 	வென்னீர் என்பதன் பொருள் வெல்லும் தன்மை 
அணல் என்பதன் பொருள் நெருப்பு 	அனல் என்பதன் பொருள் நெருப்பு 
அனல் என்பதன் பொருள் கழுத்து 	அணல் என்பதன் பொருள் கழுத்து 
அனி என்பதன் பொருள் அழகு 	அணி என்பதன் பொருள் அழகு 
அணி என்பதன் பொருள் நெற்பொறி	அனி என்பதன் பொருள் நெற்பொறி
அனு என்பதன் பொருள் நுண்மை	அணு என்பதன் பொருள் நுண்மை
அணு என்பதன் பொருள் தாடை	அனு என்பதன் பொருள் தாடை
அனுக்கம் என்பதன் பொருள் அண்மை	அணுக்கம் என்பதன் பொருள் அண்மை
அணுக்கம் என்பதன் பொருள் அச்சம்	அனுக்கம் என்பதன் பொருள் அச்சம்
அனை என்பதன் பொருள் படுக்கை	அணை என்பதன் பொருள் படுக்கை
அனை என்பதன் பொருள் அணைத்துக் கொள்ளுதல்	அணை என்பதன் பொருள் அணைத்துக் கொள்ளுதல்
அணை என்பதன் பொருள் அன்னை	அனை என்பதன் பொருள் அன்னை
அணை என்பதன் பொருள் மீன்	அனை என்பதன் பொருள் மீன்
அனைய என்பதன் பொருள் சேர 	அணைய என்பதன் பொருள் சேர 
அனைய என்பதன் பொருள் அடைய	அணைய என்பதன் பொருள் அடைய
அணைய என்பதன் பொருள் அத்தகைய	அனைய என்பதன் பொருள் அத்தகைய
அன்மை என்பதன் பொருள் அருகில்	அண்மை என்பதன் பொருள் அருகில்
அண்மை என்பதன் பொருள் தீமை	அன்மை என்பதன் பொருள் தீமை
அங்கன் என்பதன் பொருள் அவ்விடம்	அங்கண் என்பதன் பொருள் அவ்விடம்
அங்கண் என்பதன் பொருள் மகன்	அங்கன் என்பதன் பொருள் மகன்
அன்னம் என்பதன் பொருள் மேல்வாய்	அண்ணம் என்பதன் பொருள் மேல்வாய்
அண்ணம் என்பதன் பொருள் சோறு	அன்னம் என்பதன் பொருள் சோறு
அண்ணம் என்பதன் பொருள் அன்னப்பறவை	அன்னம் என்பதன் பொருள் அன்னப்பறவை
அன்னன் என்பதன் பொருள் தமையன்	அண்ணன் என்பதன் பொருள் தமையன்
அண்ணன் என்பதன் பொருள் அத்தகையவன்	அன்னன் என்பதன் பொருள் அத்தகையவன்
அவன் என்பதன் பொருள் அவ்வாறு	அவண் என்பதன் பொருள் அவ்வாறு
அவண் செய்தான்	அவன் செய்தான்
ஆனகம் என்பதன் பொருள் சுரை	ஆணகம் என்பதன் பொருள் சுரை
ஆணகம் என்பதன் பொருள் துந்துபி	ஆனகம் என்பதன் பொருள் துந்துபி
ஆனம் என்பதன் பொருள் பற்றுக்கோடு	ஆணம் என்பதன் பொருள் பற்றுக்கோடு
ஆணம் என்பதன் பொருள் தெப்பம்	ஆனம் என்பதன் பொருள் தெப்பம்
ஆணம் என்பதன் பொருள் கள்	ஆனம் என்பதன் பொருள் கள்
ஆனி என்பதன் பொருள் எழுத்தாணி	ஆணி என்பதன் பொருள் எழுத்தாணி
ஆனி என்பதன் பொருள் இரும்பாணி	ஆணி என்பதன் பொருள் இரும்பாணி
ஆணி என்பது தமிழ் மாதங்களுள் ஒன்று	ஆனி என்பது தமிழ் மாதங்களுள் ஒன்று
ஆனேறு என்பதன் பொருள்  ஆண்மகன்	ஆணேறு என்பதன் பொருள்  ஆண்மகன்
ஆணேறு என்பதன் பொருள் காளை	ஆனேறு என்பதன் பொருள் காளை
ஆணேறு என்பதன் பொருள் எருது	ஆனேறு என்பதன் பொருள் எருது
ஆன் என்பதன் பொருள் ஆடவன்	ஆண் என்பதன் பொருள் ஆடவன்
ஆண் என்பதன் பொருள் பசு	ஆன் என்பதன் பொருள் பசு
ஆனை என்பதன் பொருள் கட்டளை	ஆணை என்பதன் பொருள் கட்டளை
ஆணை என்பதன் பொருள் யானை	ஆனை என்பதன் பொருள் யானை
இனை என்பதன் பொருள் துணை	இணை என்பதன் பொருள் துணை
இனை என்பதன் பொருள் இரட்டை	இணை என்பதன் பொருள் இரட்டை
இணை என்பதன் பொருள் வருத்தம்	இனை என்பதன் பொருள் வருத்தம்
இனைத்து என்பதன் பொருள் சேர்த்து	இணைத்து என்பதன் பொருள் சேர்த்து
இணைத்து என்பதன் பொருள் இத்தன்மையது	இனைத்து என்பதன் பொருள் இத்தன்மையது
இவன் என்பதன் பொருள் இவ்வாறு	இவண் என்பதன் பொருள் இவ்வாறு
இவண் என்ன வரைந்தான்?	இவன் என்ன வரைந்தான்?
ஈனவள் என்பதன் பொருள் ஈன்றவள்	ஈணவள் என்பதன் பொருள் ஈன்றவள்
ஈணவள் என்பதன் பொருள் இழிந்தவள்	ஈனவள் என்பதன் பொருள் இழிந்தவள்
உண் ஓவியம் 	உன் ஓவியம் 
சோறு உன்டான் 	சோறு உண்டான் 
உன்னல் என்பதன் பொருள் உண்ணுதல்	உண்ணல் என்பதன் பொருள் உண்ணுதல்
உண்ணல் என்பதன் பொருள் நினைத்தல்	உன்னல் என்பதன் பொருள் நினைத்தல்
உன்னி என்பதன் பொருள் ஒருவகைப் பூச்சி	உண்ணி என்பதன் பொருள் ஒருவகைப் பூச்சி
உன்னி என்பதன் பொருள் உண்பவன்	உண்ணி என்பதன் பொருள் உண்பவன்
உண்ணி என்பதன் பொருள் நினைத்து	உன்னி என்பதன் பொருள் நினைத்து
உண்ணி என்பதன் பொருள் குதிரை	உன்னி என்பதன் பொருள் குதிரை
ஊன் என்பதன் பொருள் உணவு	ஊண் என்பதன் பொருள் உணவு
ஊண் என்பதன் பொருள் மாமிசம்	ஊன் என்பதன் பொருள் மாமிசம்
அவளை என்னிக் கொண்டான் 	அவளை எண்ணிக் கொண்டான் 
விலை எண்ண?	விலை என்ன?
என்னல் என்பதன் பொருள் எண்ணுதல்	எண்ணல் என்பதன் பொருள் எண்ணுதல்
எண்ணல் என்பதன் பொருள் என்று சொல்லுதல்	என்னல் என்பதன் பொருள் என்று சொல்லுதல்
என்கு என்பதன் பொருள் கரடி	எண்கு என்பதன் பொருள் கரடி
எண்கு என்பதன் பொருள் என்று சொல்லுதல்	என்கு என்பதன் பொருள் என்று சொல்லுதல்
ஏன் என்பதன் பொருள் வலிமை	ஏண் என்பதன் பொருள் வலிமை
ஏன் என்பதன் பொருள் எல்லை 	ஏண் என்பதன் பொருள் எல்லை 
பெண் ஏண் அடிமையானாள்? 	பெண் ஏன் அடிமையானாள்? 
ஏனை என்பதன் பொருள் தொட்டில்	ஏணை என்பதன் பொருள் தொட்டில்
ஏணை என்பதன் பொருள் மற்றது	ஏனை என்பதன் பொருள் மற்றது
ஐவனம் என்பதன் பொருள் ஐந்து வண்ணம்	ஐவணம் என்பதன் பொருள் ஐந்து வண்ணம்
ஐவணம் என்பதன் பொருள் மலை நெல்	ஐவனம் என்பதன் பொருள் மலை நெல்
ஓனம் என்பதன் பொருள் ஒரு பண்டிகை	ஓணம் என்பதன் பொருள் ஒரு பண்டிகை
ஓணம் என்பதன் பொருள் எழுத்துச்சாரியை	ஓனம் என்பதன் பொருள் எழுத்துச்சாரியை
கனகம் என்பதன் பொருள் ஒரு படைப்பிரிவு	கணகம் என்பதன் பொருள் ஒரு படைப்பிரிவு
கணகம் என்பதன் பொருள் பொன்	கனகம் என்பதன் பொருள் பொன்
கனப்பு என்பதன் பொருள் குளிர்காயும் தீ	கணப்பு என்பதன் பொருள் குளிர்காயும் தீ
கணப்பு என்பதன் பொருள் பாரம்	கனப்பு என்பதன் பொருள் பாரம்
கணப்பு என்பதன் பொருள் அழுத்தம்	கனப்பு என்பதன் பொருள் அழுத்தம்
கனி என்பதன் பொருள் கணித்தல்	கணி என்பதன் பொருள் கணித்தல்
கணி என்பதன் பொருள் பழம்	கனி என்பதன் பொருள் பழம்
கணி என்பதன் பொருள் சுரங்கம்	கனி என்பதன் பொருள் சுரங்கம்
கணி என்பதன் பொருள் சாரம்	கனி என்பதன் பொருள் சாரம்
கனம் என்பதன் பொருள் கூட்டம்	கணம் என்பதன் பொருள் கூட்டம்
கணம் என்பதன் பொருள் பாரம்	கனம் என்பதன் பொருள் பாரம்
கன்னன் என்பதன் பொருள் கிருஷ்ணன்	கண்ணன் என்பதன் பொருள் கிருஷ்ணன்
கண்ணன் என்பதன் பொருள் கர்ணன்	கன்னன் என்பதன் பொருள் கர்ணன்
கன்னி என்பதன் பொருள் மாலை	கண்ணி என்பதன் பொருள் மாலை
கன்னி என்பதன் பொருள் கயிறு	கண்ணி என்பதன் பொருள் கயிறு
கன்னி என்பதன் பொருள் தாம்பு	கண்ணி என்பதன் பொருள் தாம்பு
கண்ணி என்பதன் பொருள் குமரிப்பெண்	கன்னி என்பதன் பொருள் குமரிப்பெண்
கண்ணி என்பதன் பொருள் உமை	கன்னி என்பதன் பொருள் உமை
கண்ணி ஒரு ராசி	கன்னி ஒரு ராசி
கனை என்பதன் பொருள் அம்பு	கணை என்பதன் பொருள் அம்பு
கணை என்பதன் பொருள் ஒலி	கனை என்பதன் பொருள் ஒலி
கணை என்பதன் பொருள் கனைத்தல்	கனை என்பதன் பொருள் கனைத்தல்
கன் என்பதன் பொருள் ஓர் உறுப்பு	கண் என்பதன் பொருள் ஓர் உறுப்பு
கண் என்பதன் பொருள் கல் 	கன் என்பதன் பொருள் கல் 
கண் என்பதன் பொருள் செம்பு	கன் என்பதன் பொருள் செம்பு
கண் என்பதன் பொருள் உறுதி	கன் என்பதன் பொருள் உறுதி
கன்று என்பதன் பொருள் அம்பு	கண்று என்பதன் பொருள் அம்பு
கண்று என்பதன் பொருள் அற்பம்	கன்று என்பதன் பொருள் அற்பம்
கண்று என்பதன் பொருள் இளமரம்	கன்று என்பதன் பொருள் இளமரம்
கண்று என்பதன் பொருள் குட்டி	கன்று என்பதன் பொருள் குட்டி
கண்று என்பதன் பொருள் கைவளை	கன்று என்பதன் பொருள் கைவளை
கன்னல் என்பதன் பொருள் கருதல்	கண்ணல் என்பதன் பொருள் கருதல்
கண்ணல் என்பதன் பொருள் கரும்பு	கன்னல் என்பதன் பொருள் கரும்பு
கண்ணல் என்பதன் பொருள் கற்கண்டு	கன்னல் என்பதன் பொருள் கற்கண்டு
கான் என்பதன் பொருள்  பார்	காண் என்பதன் பொருள்  பார்
காண் என்பதன் பொருள் காடு	கான் என்பதன் பொருள் காடு
காண் என்பதன் பொருள் வனம்	கான் என்பதன் பொருள் வனம்
கானம் என்பதன் பொருள் பொன்	காணம் என்பதன் பொருள் பொன்
கானம் என்பதன் பொருள் கொள்	காணம் என்பதன் பொருள் கொள்
காணம் என்பதன் பொருள் இசை	கானம் என்பதன் பொருள் இசை
காணம் என்பதன் பொருள் காடு	கானம் என்பதன் பொருள் காடு
காணம் என்பதன் பொருள் வனம்	கானம் என்பதன் பொருள் வனம்
காணம் என்பதன் பொருள் தேர்	கானம் என்பதன் பொருள் தேர்
கானல் என்பதன் பொருள் பார்த்தல்	காணல் என்பதன் பொருள் பார்த்தல்
காணல் என்பதன் பொருள் பாலை	கானல் என்பதன் பொருள் பாலை
கினி என்பதன் பொருள் கைத்தாளம்	கிணி என்பதன் பொருள் கைத்தாளம்
கிணி என்பதன் பொருள் பீடை	கினி என்பதன் பொருள் பீடை
கின்னம் என்பதன் பொருள் வட்டில்	கிண்ணம் என்பதன் பொருள் வட்டில்
கின்னம் என்பதன் பொருள் கிண்ணி	கிண்ணம் என்பதன் பொருள் கிண்ணி
கிண்ணம் என்பதன் பொருள் கிளை	கின்னம் என்பதன் பொருள் கிளை
கிண்ணம் என்பதன் பொருள் துன்பம்	கின்னம் என்பதன் பொருள் துன்பம்
குனி என்பதன் பொருள் வில்	குணி என்பதன் பொருள் வில்
குனி என்பதன் பொருள் ஊமை	குணி என்பதன் பொருள் ஊமை
குணி என்பதன் பொருள் குனிதல்	குனி என்பதன் பொருள் குனிதல்
குணி என்பதன் பொருள் வளை	குனி என்பதன் பொருள் வளை
குனித்தல் என்பதன் பொருள் மதித்தல்	குணித்தல் என்பதன் பொருள் மதித்தல்
குனித்தல் என்பதன் பொருள் எண்ணுதல்	குணித்தல் என்பதன் பொருள் எண்ணுதல்
குணித்தல் என்பதன் பொருள் வளைதல்	குனித்தல் என்பதன் பொருள் வளைதல்
குனிப்பு என்பதன் பொருள் அளவு	குணிப்பு என்பதன் பொருள் அளவு
குனிப்பு என்பதன் பொருள் ஆராய்ச்சி	குணிப்பு என்பதன் பொருள் ஆராய்ச்சி
குணிப்பு என்பதன் பொருள் வளைப்பு	குனிப்பு என்பதன் பொருள் வளைப்பு
குணிப்பு என்பதன் பொருள் ஆடல்	குனிப்பு என்பதன் பொருள் ஆடல்
கேனம் என்பதன் பொருள் செழிப்பு	கேணம் என்பதன் பொருள் செழிப்பு
கேனம் என்பதன் பொருள் மிகுதி	கேணம் என்பதன் பொருள் மிகுதி
கேணம் என்பதன் பொருள் பைத்தியம்	கேனம் என்பதன் பொருள் பைத்தியம்
கேணம் என்பதன் பொருள் பித்து	கேனம் என்பதன் பொருள் பித்து
கேனி என்பதன் பொருள் கிணறு	கேணி என்பதன் பொருள் கிணறு
கேணி என்பதன் பொருள் பித்துப் பிடித்தவர்	கேனி என்பதன் பொருள் பித்துப் பிடித்தவர்
கோன் என்பதன் பொருள் கோணல்	கோண் என்பதன் பொருள் கோணல்
கோன் என்பதன் பொருள் மாறுபாடு	கோண் என்பதன் பொருள் மாறுபாடு
கோண் என்பதன் பொருள் அரசன்	கோன் என்பதன் பொருள் அரசன்
சானம் என்பதன் பொருள் சாணைக்கல்	சாணம் என்பதன் பொருள் சாணைக்கல்
சானம் என்பதன் பொருள் சாணி	சாணம் என்பதன் பொருள் சாணி
சாணம் என்பதன் பொருள் அம்மி	சானம் என்பதன் பொருள் அம்மி
சாணம் என்பதன் பொருள் பெருங்காயம்	சானம் என்பதன் பொருள் பெருங்காயம்
சுனை என்பதன் பொருள் கூர்மை	சுணை என்பதன் பொருள் கூர்மை
சுனை என்பதன் பொருள் கரணை	சுணை என்பதன் பொருள் கரணை
சுணை என்பதன் பொருள் நீரூற்று	சுனை என்பதன் பொருள் நீரூற்று
சுன்னம் என்பதன் பொருள் வாசனைப் பொடி	சுண்ணம் என்பதன் பொருள் வாசனைப் பொடி
சுண்ணம் என்பதன் பொருள் சுண்ணாம்பு	சுன்னம் என்பதன் பொருள் சுண்ணாம்பு
சுண்ணம் என்பதன் பொருள் பூஜ்ஜியம்	சுன்னம் என்பதன் பொருள் பூஜ்ஜியம்
சேனம் என்பதன் பொருள் மெத்தை	சேணம் என்பதன் பொருள் மெத்தை
சேணம் என்பதன் பொருள் பருந்து	சேனம் என்பதன் பொருள் பருந்து
சேனை என்பதன் பொருள் அறிவு	சேணை என்பதன் பொருள் அறிவு
சேணை என்பதன் பொருள் படை	சேனை என்பதன் பொருள் படை
சோனம் என்பதன் பொருள் பொன்	சோணம் என்பதன் பொருள் பொன்
சோனம் என்பதன் பொருள் சிவப்பு	சோணம் என்பதன் பொருள் சிவப்பு
சோனம் என்பதன் பொருள் தீ	சோணம் என்பதன் பொருள் தீ
சோனம் என்பதன் பொருள் சோணகிரி	சோணம் என்பதன் பொருள் சோணகிரி
சோணம் என்பதன் பொருள் மேகம்	சோனம் என்பதன் பொருள் மேகம்
சோனை என்பதன் பொருள் ஒரு நதி	சோணை என்பதன் பொருள் ஒரு நதி
சோனை என்பதன் பொருள் சேரன் மனைவி	சோணை என்பதன் பொருள் சேரன் மனைவி
சோணை என்பதன் பொருள் மழைச்சாரல்	சோனை என்பதன் பொருள் மழைச்சாரல்
சோணை என்பதன் பொருள் மேகம்	சோனை என்பதன் பொருள் மேகம்
தன் என்பதன் பொருள் குளிர்ச்சி	தண் என்பதன் பொருள் குளிர்ச்சி
தண் என்பதன் பொருள் தன்னுடைய	தன் என்பதன் பொருள் தன்னுடைய
தனி என்பதன் பொருள் தணித்தல்	தணி என்பதன் பொருள் தணித்தல்
தணி என்பதன் பொருள் தனிமை	தனி என்பதன் பொருள் தனிமை
தானி என்பதன் பொருள் தான்றிமரம்	தாணி என்பதன் பொருள் தான்றிமரம்
தாணி என்பதன் பொருள் இருப்பிடம்	தானி என்பதன் பொருள் இருப்பிடம்
தாணி என்பதன் பொருள் பண்டசாலை	தானி என்பதன் பொருள் பண்டசாலை
தானு என்பதன் பொருள் சிவன்	தாணு என்பதன் பொருள் சிவன்
தானு என்பதன் பொருள் தூண்	தாணு என்பதன் பொருள் தூண்
தானு என்பதன் பொருள் நிலைப்பேறு	தாணு என்பதன் பொருள் நிலைப்பேறு
தாணு என்பதன் பொருள் காற்று	தானு என்பதன் பொருள் காற்று
தினை என்பதன் பொருள் ஒழுக்கம்	திணை என்பதன் பொருள் ஒழுக்கம்
தினை என்பதன் பொருள் குலம்	திணை என்பதன் பொருள் குலம்
திணை என்பதன் பொருள் தானியம்	தினை என்பதன் பொருள் தானியம்
திணை ஒருவகைப் புன்செய்ப் பயிர்	தினை ஒருவகைப் புன்செய்ப் பயிர்
தின்மை என்பதன் பொருள் உறுதி	திண்மை என்பதன் பொருள் உறுதி
திண்மை என்பதன் பொருள் தீமை	தின்மை என்பதன் பொருள் தீமை
தின் என்பதன் பொருள் வலிமை	திண் என்பதன் பொருள் வலிமை
திண் என்பதன் பொருள் உண்	தின் என்பதன் பொருள் உண்
துனி என்பதன் பொருள் துணிதல்	துணி என்பதன் பொருள் துணிதல்
துனி என்பதன் பொருள் கந்தை	துணி என்பதன் பொருள் கந்தை
துணி என்பதன் பொருள் அச்சம்	துனி என்பதன் பொருள் அச்சம்
துணி என்பதன் பொருள் ஊடல் நீட்டித்தல்	துனி என்பதன் பொருள் ஊடல் நீட்டித்தல்
தென் என்பதன் பொருள் தெளிவு	தெண் என்பதன் பொருள் தெளிவு
தெண் என்பதன் பொருள் தெற்கு	தென் என்பதன் பொருள் தெற்கு
தெண் என்பதன் பொருள் அழகு	தென் என்பதன் பொருள் அழகு
நன்பகல் என்பதன் பொருள் நடுப்பகல்	நண்பகல் என்பதன் பொருள் நடுப்பகல்
நண்பகல் என்பதன் பொருள் நல்லபகல்	நன்பகல் என்பதன் பொருள் நல்லபகல்
நனி என்பதன் பொருள் அணி 	நணி என்பதன் பொருள் அணி 
நனி என்பதன் பொருள் அழகு	நணி என்பதன் பொருள் அழகு
நணி என்பதன் பொருள் மிகுதி	நனி என்பதன் பொருள் மிகுதி
நான் என்பதன் பொருள் வெட்கம்	நாண் என்பதன் பொருள் வெட்கம்
நான் என்பதன் பொருள் கயிறு	நாண் என்பதன் பொருள் கயிறு
நாண் என்பது தன்மைப் பெயர்	நான் என்பது தன்மைப் பெயர்
நானம் என்பதன் பொருள் வெட்கம்	நாணம் என்பதன் பொருள் வெட்கம்
நாணம் என்பதன் பொருள் புனுகு	நானம் என்பதன் பொருள் புனுகு
நாணம் என்பதன் பொருள் கவரிமான்	நானம் என்பதன் பொருள் கவரிமான்
பனி என்பதன் பொருள் வேலை	பணி என்பதன் பொருள் வேலை
பனி என்பதன் பொருள் கட்டளையிடு	பணி என்பதன் பொருள் கட்டளையிடு
பணி என்பதன் பொருள் துன்பம்	பனி என்பதன் பொருள் துன்பம்
பணி என்பதன் பொருள் குளிர்	பனி என்பதன் பொருள் குளிர்
பணி என்பதன் பொருள் சொல்	பனி என்பதன் பொருள் சொல்
பணி என்பதன் பொருள் நோய்	பனி என்பதன் பொருள் நோய்
பனை என்பதன் பொருள் முரசு 	பணை என்பதன் பொருள் முரசு 
பனை என்பதன் பொருள் உயரம்	பணை என்பதன் பொருள் உயரம்
பனை என்பதன் பொருள் பரந்த	பணை என்பதன் பொருள் பரந்த
பணை ஒருவகை மரம்	பனை ஒருவகை மரம்
பன் என்பதன் பொருள் இசை	பண் என்பதன் பொருள் இசை
பண் என்பதன் பொருள் அரிவாள்	பன் என்பதன் பொருள் அரிவாள்
பண் என்பதன் பொருள் பல	பன் என்பதன் பொருள் பல
பன்னை என்பதன் பொருள் தோட்டம்	பண்ணை என்பதன் பொருள் தோட்டம்
பண்ணை என்பதன் பொருள் கீரைச்செடி	பன்னை என்பதன் பொருள் கீரைச்செடி
பன்னுதல் என்பதன் பொருள் செய்தல்	பண்ணுதல் என்பதன் பொருள் செய்தல்
பண்ணுதல் என்பதன் பொருள் நெருங்குதல்	பன்னுதல் என்பதன் பொருள் நெருங்குதல்
பன்னி என்பதன் பொருள் செய்து	பண்ணி என்பதன் பொருள் செய்து
பண்ணி என்பதன் பொருள் சீப்பு	பன்னி என்பதன் பொருள் சீப்பு
பண்ணி என்பதன் பொருள் பனிநீர்	பன்னி என்பதன் பொருள் பனிநீர்
பண்ணி என்பதன் பொருள் மனை	பன்னி என்பதன் பொருள் மனை
பண்ணி என்பதன் பொருள் சணல்	பன்னி என்பதன் பொருள் சணல்
பன்மை என்பதன் பொருள் தகுதி	பண்மை என்பதன் பொருள் தகுதி
பண்மை என்பதன் பொருள் பல	பன்மை என்பதன் பொருள் பல
பனித்தல் என்பதன் பொருள் கட்டளையிடுதல்	பணித்தல் என்பதன் பொருள் கட்டளையிடுதல்
பணித்தல் என்பதன் பொருள் துளித்தல்	பனித்தல் என்பதன் பொருள் துளித்தல்
பணித்தல் என்பதன் பொருள் தூறல்	பனித்தல் என்பதன் பொருள் தூறல்
பணித்தல் என்பதன் பொருள் விரிந்த	பனித்தல் என்பதன் பொருள் விரிந்த
பட்டனம் என்பதன் பொருள் நகரம்	பட்டணம் என்பதன் பொருள் நகரம்
பட்டிணம் என்பதன் பொருள் கடற்கரை நகர்	பட்டினம் என்பதன் பொருள் கடற்கரை நகர்
பானம் என்பதன் பொருள் நீருணவு	பாணம் என்பதன் பொருள் நீருணவு
பாணம் என்பதன் பொருள் அம்பு	பானம் என்பதன் பொருள் அம்பு
புனை என்பதன் பொருள் தெப்பம்	புணை என்பதன் பொருள் தெப்பம்
புணை என்பதன் பொருள் இட்டுக்கட்டுதல்	புனை என்பதன் பொருள் இட்டுக்கட்டுதல்
புணை என்பதன் பொருள் கற்பனை	புனை என்பதன் பொருள் கற்பனை
புன் என்பதன் பொருள் காயம்	புண் என்பதன் பொருள் காயம்
புண் என்பதன் பொருள் கீழான	புன் என்பதன் பொருள் கீழான
பேனம் என்பதன் பொருள் பேணுதல்	பேணம் என்பதன் பொருள் பேணுதல்
பேணம் என்பதன் பொருள் நுரை	பேனம் என்பதன் பொருள் நுரை
பேன் என்பதன் பொருள் போற்று	பேண் என்பதன் பொருள் போற்று
பேன் என்பதன் பொருள் உபசரி	பேண் என்பதன் பொருள் உபசரி
பேண் என்பதன் பொருள் ஓர் உயிரி	பேன் என்பதன் பொருள் ஓர் உயிரி
மனம் என்பதன் பொருள் வாசனை	மணம் என்பதன் பொருள் வாசனை
மனம் என்பதன் பொருள் திருமணம்	மணம் என்பதன் பொருள் திருமணம்
மணம் என்பதன் பொருள் உள்ளம்	மனம் என்பதன் பொருள் உள்ளம்
மணம் என்பதன் பொருள் இந்துப்பு	மனம் என்பதன் பொருள் இந்துப்பு
மனை என்பதன் பொருள் மரப்பலகை	மணை என்பதன் பொருள் மரப்பலகை
மனை என்பதன் பொருள் மணவறை	மணை என்பதன் பொருள் மணவறை
மணை என்பதன் பொருள் இடம்	மனை என்பதன் பொருள் இடம்
மணை என்பதன் பொருள் வீடு	மனை என்பதன் பொருள் வீடு
மன் என்பதன் பொருள் தரை	மண் என்பதன் பொருள் தரை
மன் என்பதன் பொருள் மண்வகை	மண் என்பதன் பொருள் மண்வகை
மண் என்பதன் பொருள் மன்னன்	மன் என்பதன் பொருள் மன்னன்
மண் என்பதன் பொருள் பெருமை	மன் என்பதன் பொருள் பெருமை
மன்னை என்பதன் பொருள் இளமை	மண்ணை என்பதன் பொருள் இளமை
மன்னை என்பது கொடி வகை	மண்ணை என்பது கொடி வகை
மண்ணை என்பதன் பொருள் தொண்டை	மன்னை என்பதன் பொருள் தொண்டை
மண்ணை என்பதன் பொருள் கோபம்	மன்னை என்பதன் பொருள் கோபம்
மானி என்பதன் பொருள் அழகு	மாணி என்பதன் பொருள் அழகு
மானி என்பதன் பொருள் பிரம்மசாரி	மாணி என்பதன் பொருள் பிரம்மசாரி
மாணி என்பதன் பொருள் மானம் உடையவர்	மானி என்பதன் பொருள் மானம் உடையவர்
மான் என்பதன் பொருள் மாட்சிமை	மாண் என்பதன் பொருள் மாட்சிமை
மாண் என்பதன் பொருள் ஒரு விலங்கு	மான் என்பதன் பொருள் ஒரு விலங்கு
முனை என்பதன் பொருள் வெறுப்பு	முணை என்பதன் பொருள் வெறுப்பு
முனை என்பதன் பொருள் மிகுதி	முணை என்பதன் பொருள் மிகுதி
முணை என்பதன் பொருள் முன்பகுதி	முனை என்பதன் பொருள் முன்பகுதி
முணை என்பதன் பொருள் துணிவு	முனை என்பதன் பொருள் துணிவு
முணை என்பதன் பொருள் முதன்மை	முனை என்பதன் பொருள் முதன்மை
வனம் என்பதன் பொருள் ஓசை	வணம் என்பதன் பொருள் ஓசை
வணம் என்பதன் பொருள் காடு	வனம் என்பதன் பொருள் காடு
வணம் என்பதன் பொருள் துளசி	வனம் என்பதன் பொருள் துளசி
வன்மை என்பதன் பொருள் வளப்பம்	வண்மை என்பதன் பொருள் வளப்பம்
வன்மை என்பதன் பொருள் கொடை	வண்மை என்பதன் பொருள் கொடை
வண்மை என்பதன் பொருள் உறுதி	வன்மை என்பதன் பொருள் உறுதி
வண்மை என்பதன் பொருள் வலிமை	வன்மை என்பதன் பொருள் வலிமை
வன்னம் என்பதன் பொருள் நிறம்	வண்ணம் என்பதன் பொருள் நிறம்
வன்னம் என்பதன் பொருள் குணம்	வண்ணம் என்பதன் பொருள் குணம்
வன்னம் என்பதன் பொருள் அழகு	வண்ணம் என்பதன் பொருள் அழகு
வண்ணம் என்பதன் பொருள் எழுத்து	வன்னம் என்பதன் பொருள் எழுத்து
வண்ணம் என்பதன் பொருள் நிறம்	வன்னம் என்பதன் பொருள் நிறம்
வானகம் என்பதன் பொருள் அக்கினி 	வாணகம் என்பதன் பொருள் அக்கினி 
வானகம்  என்பதன் பொருள் பசுமடி	வாணகம் என்பதன் பொருள் பசுமடி
வாணகம் என்பதன் பொருள் மேலுலகம்	வானகம் என்பதன் பொருள் மேலுலகம்
வானம் என்பதன் பொருள் அம்பு	வாணம் என்பதன் பொருள் அம்பு
வானம் என்பதன் பொருள் தீ	வாணம் என்பதன் பொருள் தீ
வானம் என்பதன் பொருள் மத்தாப்பு	வாணம் என்பதன் பொருள் மத்தாப்பு
வாணம் என்பதன் பொருள் ஆகாயம்	வானம் என்பதன் பொருள் ஆகாயம்
வாணம் என்பதன் பொருள் மழை	வானம் என்பதன் பொருள் மழை
வானி என்பதன் பொருள் கலைமகள்	வாணி என்பதன் பொருள் கலைமகள்
வானி என்பதன் பொருள் சரஸ்வதி	வாணி என்பதன் பொருள் சரஸ்வதி
வாணி என்பதன் பொருள் துகிற்கொடி	வானி என்பதன் பொருள் துகிற்கொடி
அளகு என்பதன் பொருள் பறவையின் மூக்கு	அலகு என்பதன் பொருள் பறவையின் மூக்கு
அழகு என்பதன் பொருள் பறவையின் மூக்கு	அலகு என்பதன் பொருள் பறவையின் மூக்கு
அலகு என்பதன் பொருள் வனப்பு	அழகு என்பதன் பொருள் வனப்பு
அளகு என்பதன் பொருள் வனப்பு	அழகு என்பதன் பொருள் வனப்பு
அழகு என்பதன் பொருள் சேவல்	அளகு என்பதன் பொருள் சேவல்
அலகு என்பதன் பொருள் சேவல்	அளகு என்பதன் பொருள் சேவல்
அழகு என்பதன் பொருள் பெண்கூகை	அளகு என்பதன் பொருள் பெண்கூகை
அலகு என்பதன் பொருள் பெண்கூகை	அளகு என்பதன் பொருள் பெண்கூகை
அளகம் என்பதன் பொருள் திப்பிலி	அலகம் என்பதன் பொருள் திப்பிலி
அழகம் என்பதன் பொருள் திப்பிலி	அலகம் என்பதன் பொருள் திப்பிலி
அலகம் என்பதன் பொருள் வெள்ளெருக்கு	அளகம் என்பதன் பொருள் வெள்ளெருக்கு
அழகம் என்பதன் பொருள் வெள்ளெருக்கு	அளகம் என்பதன் பொருள் வெள்ளெருக்கு
அலகம் என்பதன் பொருள் நீர்	அளகம் என்பதன் பொருள் நீர்
அழகம் என்பதன் பொருள் நீர்	அளகம் என்பதன் பொருள் நீர்
அளகை என்பதன் பொருள் கற்றாழை	அலகை என்பதன் பொருள் கற்றாழை
அழகை என்பதன் பொருள் கற்றாழை	அலகை என்பதன் பொருள் கற்றாழை
அளகை என்பதன் பொருள் பேய்	அலகை என்பதன் பொருள் பேய்
அழகை என்பதன் பொருள் பேய்	அலகை என்பதன் பொருள் பேய்
அலகை என்பதன் பொருள் அளகாபுரி	அளகை என்பதன் பொருள் அளகாபுரி
அழகை என்பதன் பொருள் அளகாபுரி	அளகை என்பதன் பொருள் அளகாபுரி
அலகை என்பதன் பொருள் பெண்	அளகை என்பதன் பொருள் பெண்
அழகை என்பதன் பொருள் பெண்	அளகை என்பதன் பொருள் பெண்
அலம் என்பதன் பொருள் பிணம்	அழம் என்பதன் பொருள் பிணம்
அளம் என்பதன் பொருள் கலப்பை	அலம் என்பதன் பொருள் கலப்பை
அலம் என்பதன் பொருள் உப்பு	அளம் என்பதன் பொருள் உப்பு
அழம் என்பதன் பொருள் உப்பு	அளம் என்பதன் பொருள் உப்பு
அளத்தல் என்பதன் பொருள் அலட்டல்	அலத்தல் என்பதன் பொருள் அலட்டல்
அழத்தல் என்பதன் பொருள் அலட்டல்	அலத்தல் என்பதன் பொருள் அலட்டல்
அளத்தல் என்பதன் பொருள் அலைதல்	அலத்தல் என்பதன் பொருள் அலைதல்
அழத்தல் என்பதன் பொருள் அலைதல்	அலத்தல் என்பதன் பொருள் அலைதல்
அலத்தல் என்பதன் பொருள் அளவிடுதல்	அளத்தல் என்பதன் பொருள் அளவிடுதல்
அழத்தல் என்பதன் பொருள் அளவிடுதல்	அளத்தல் என்பதன் பொருள் அளவிடுதல்
அலத்தல் என்பதன் பொருள் மதித்தல்	அளத்தல் என்பதன் பொருள் மதித்தல்
அழத்தல் என்பதன் பொருள் மதித்தல்	அளத்தல் என்பதன் பொருள் மதித்தல்
அளவன் என்பதன் பொருள் ஆண்நண்டு	அலவன் என்பதன் பொருள் ஆண்நண்டு
அழவன் என்பதன் பொருள் ஆண்நண்டு	அலவன் என்பதன் பொருள் ஆண்நண்டு
அலவன் என்பதன் பொருள் அளப்பவன்	அளவன் என்பதன் பொருள் அளப்பவன்
அழவன் என்பதன் பொருள் அளப்பவன்	அளவன் என்பதன் பொருள் அளப்பவன்
அலவன் என்பதன் பொருள் உப்பு எடுப்போன்	அளவன் என்பதன் பொருள் உப்பு எடுப்போன்
அழவன் என்பதன் பொருள் உப்பு எடுப்போன்	அளவன் என்பதன் பொருள் உப்பு எடுப்போன்
அலி என்பதன் பொருள் அழித்துவிடு	அழி என்பதன் பொருள் அழித்துவிடு
அளி என்பதன் பொருள் அழித்துவிடு	அழி என்பதன் பொருள் அழித்துவிடு
அளி என்பதன் பொருள் பேடி	அலி என்பதன் பொருள் பேடி
அழி என்பதன் பொருள் பேடி	அலி என்பதன் பொருள் பேடி
அளி என்பதன் பொருள் காகம்	அலி என்பதன் பொருள் காகம்
அழி என்பதன் பொருள் காகம்	அலி என்பதன் பொருள் காகம்
அளி என்பதன் பொருள் விருச்சிகராசி	அலி என்பதன் பொருள் விருச்சிகராசி
அழி என்பதன் பொருள் விருச்சிகராசி	அலி என்பதன் பொருள் விருச்சிகராசி
அலி என்பதன் பொருள் கருணை	அளி என்பதன் பொருள் கருணை
அழி என்பதன் பொருள் கருணை	அளி என்பதன் பொருள் கருணை
அலி என்பதன் பொருள் கள்	அளி என்பதன் பொருள் கள்
அழி என்பதன் பொருள் கள்	அளி என்பதன் பொருள் கள்
அலி என்பதன் பொருள் வண்டு	அளி என்பதன் பொருள் வண்டு
அழி என்பதன் பொருள் வண்டு	அளி என்பதன் பொருள் வண்டு
அள்ளல் என்பதன் பொருள் துன்பம்	அல்லல் என்பதன் பொருள் துன்பம்
அள்ளல் என்பதன் பொருள் துன்பம்	அல்லல் என்பதன் பொருள் துன்பம்
அல்லல் என்பதன் பொருள் வாரி எடுத்தல்	அள்ளல் என்பதன் பொருள் வாரி எடுத்தல்
அல்லல் என்பதன் பொருள் வாரி எடுத்தல்	அள்ளல் என்பதன் பொருள் வாரி எடுத்தல்
அளை என்பதன் பொருள் கூப்பிடு	அழை என்பதன் பொருள் கூப்பிடு
அலை என்பதன் பொருள் கூப்பிடு	அழை என்பதன் பொருள் கூப்பிடு
அழை என்பதன் பொருள் கடல்	அலை என்பதன் பொருள் கடல்
அளை என்பதன் பொருள் கடல்	அலை என்பதன் பொருள் கடல்
அளை என்பதன் பொருள் நீரலை	அலை என்பதன் பொருள் நீரலை
அழை என்பதன் பொருள் அலைதல்	அலை என்பதன் பொருள் அலைதல்
அலை என்பதன் பொருள் தயிர்	அளை என்பதன் பொருள் தயிர்
அழை என்பதன் பொருள் தயிர்	அளை என்பதன் பொருள் தயிர்
அழை என்பதன் பொருள் நண்டு	அளை என்பதன் பொருள் நண்டு
அலை என்பதன் பொருள் நண்டு	அளை என்பதன் பொருள் நண்டு
அலை என்பதன் பொருள் புற்று	அளை என்பதன் பொருள் புற்று
அழை என்பதன் பொருள் புற்று	அளை என்பதன் பொருள் புற்று
அவழ் என்பதன் பொருள் பள்ளம்	அவல் என்பதன் பொருள் பள்ளம்
அவள் என்பதன் பொருள் பள்ளம்	அவல் என்பதன் பொருள் பள்ளம்
அவள் ஒரு உணவுப் பொருள்	அவல் ஒரு உணவுப் பொருள்
அவழ் ஒரு உணவுப் பொருள்	அவல் ஒரு உணவுப் பொருள்
அவல் ஒரு மருத்துவர் 	அவள் ஒரு மருத்துவர் 
அவழ் ஒரு மருத்துவர் 	அவள் ஒரு மருத்துவர் 
அள் என்பதன் பொருள் இரவு	அல் என்பதன் பொருள் இரவு
அழ் என்பதன் பொருள் இரவு	அல் என்பதன் பொருள் இரவு
அல் என்பதன் பொருள் அள்ளி எடு	அள் என்பதன் பொருள் அள்ளி எடு
அழ் என்பதன் பொருள் அள்ளி எடு	அள் என்பதன் பொருள் அள்ளி எடு
அல் என்பதன் பொருள் நெருக்கம்	அள் என்பதன் பொருள் நெருக்கம்
அழ் என்பதன் பொருள் நெருக்கம்	அள் என்பதன் பொருள் நெருக்கம்
உளவு என்பதன் பொருள் நடப்பது	உலவு என்பதன் பொருள் நடப்பது
உழவு என்பதன் பொருள் நடப்பது	உலவு என்பதன் பொருள் நடப்பது
உழவு என்பதன் பொருள் ஒற்று	உளவு என்பதன் பொருள் ஒற்று
உலவு என்பதன் பொருள் ஒற்று	உளவு என்பதன் பொருள் ஒற்று
உலவு என்பதன் பொருள் கலப்பையால் உழுதல்	உழவு என்பதன் பொருள் கலப்பையால் உழுதல்
உளவு என்பதன் பொருள் கலப்பையால் உழுதல்	உழவு என்பதன் பொருள் கலப்பையால் உழுதல்
உளி என்பதன் பொருள் இடம்	உழி என்பதன் பொருள் இடம்
உலி என்பதன் பொருள் இடம்	உழி என்பதன் பொருள் இடம்
உலி என்பதன் பொருள் பொழுது	உழி என்பதன் பொருள் பொழுது
உளி என்பதன் பொருள் பொழுது	உழி என்பதன் பொருள் பொழுது
உலி என்பதன் பொருள் தச்சுக் கருவிகளுள் ஒன்று	உளி என்பதன் பொருள் தச்சுக் கருவிகளுள் ஒன்று
உழி என்பதன் பொருள் தச்சுக் கருவிகளுள் ஒன்று	உளி என்பதன் பொருள் தச்சுக் கருவிகளுள் ஒன்று
உளு என்பதன் பொருள் தானியப் பதர்	உலு என்பதன் பொருள் தானியப் பதர்
உழு என்பதன் பொருள் தானியப் பதர்	உலு என்பதன் பொருள் தானியப் பதர்
உலு என்பதன் பொருள் நிலத்தை உழு	உழு என்பதன் பொருள் நிலத்தை உழு
உளு என்பதன் பொருள் நிலத்தை உழு	உழு என்பதன் பொருள் நிலத்தை உழு
உலு என்பதன் பொருள் உளுத்துப் போதல்	உளு என்பதன் பொருள் உளுத்துப் போதல்
உழு என்பதன் பொருள் உளுத்துப் போதல்	உளு என்பதன் பொருள் உளுத்துப் போதல்
உழை என்பதன் பொருள் கொல்லன் உலை	உலை என்பதன் பொருள் கொல்லன் உலை
உளை என்பதன் பொருள் கொல்லன் உலை	உலை என்பதன் பொருள் கொல்லன் உலை
உழை என்பதன் பொருள் நீருலை	உலை என்பதன் பொருள் நீருலை
உளை என்பதன் பொருள் நீருலை	உலை என்பதன் பொருள் நீருலை
உளை என்பதன் பொருள் பாடுபடு	உழை என்பதன் பொருள் பாடுபடு
உலை என்பதன் பொருள் பாடுபடு	உழை என்பதன் பொருள் பாடுபடு
உளை என்பதன் பொருள் பக்கம்	உழை என்பதன் பொருள் பக்கம்
உலை என்பதன் பொருள் பக்கம்	உழை என்பதன் பொருள் பக்கம்
உலை என்பதன் பொருள் கலைமான்	உழை என்பதன் பொருள் கலைமான்
உளை என்பதன் பொருள் கலைமான்	உழை என்பதன் பொருள் கலைமான்
உழை என்பதன் பொருள் பிடரி மயிர்	உளை என்பதன் பொருள் பிடரி மயிர்
உலை என்பதன் பொருள் பிடரி மயிர்	உளை என்பதன் பொருள் பிடரி மயிர்
உழை என்பதன் பொருள் சேறு	உளை என்பதன் பொருள் சேறு
உலை என்பதன் பொருள் சேறு	உளை என்பதன் பொருள் சேறு
உலை என்பதன் பொருள் தலை	உளை என்பதன் பொருள் தலை
உழை என்பதன் பொருள் தலை	உளை என்பதன் பொருள் தலை
உளுவை என்பதன் பொருள் புலி	உழுவை என்பதன் பொருள் புலி
உளுவை என்பதன் பொருள் புலி	உழுவை என்பதன் பொருள் புலி
உழுவை என்பதன் பொருள் மீன்வகை	உளுவை என்பதன் பொருள் மீன்வகை
உழுவை என்பதன் பொருள் மீன்வகை	உளுவை என்பதன் பொருள் மீன்வகை
எள் என்பதன் பொருள் கல்	எல் என்பதன் பொருள் கல்
எள் என்பதன் பொருள் மாலை	எல் என்பதன் பொருள் மாலை
எள் என்பதன் பொருள் சூரியன்	எல் என்பதன் பொருள் சூரியன்
எல் என்பதன் பொருள் எண்ணெய் வித்து	எள் என்பதன் பொருள் எண்ணெய் வித்து
எல் என்பதன் பொருள் நிந்தை	எள் என்பதன் பொருள் நிந்தை
எழு என்பதன் பொருள் கரடி	எலு என்பதன் பொருள் கரடி
எழு என்பதன் பொருள் கரடி	எலு என்பதன் பொருள் கரடி
எலு என்பதன் பொருள் எழுந்திரு	எழு என்பதன் பொருள் எழுந்திரு
எலு என்பதன் பொருள் எழுந்திரு	எழு என்பதன் பொருள் எழுந்திரு
எலு என்பதன் பொருள் தூண்	எழு என்பதன் பொருள் தூண்
எலு என்பதன் பொருள் தூண்	எழு என்பதன் பொருள் தூண்
ஒளி என்பதன் பொருள் சப்தம்	ஒலி என்பதன் பொருள் சப்தம்
ஒழி என்பதன் பொருள் சப்தம்	ஒலி என்பதன் பொருள் சப்தம்
ஒளி என்பதன் பொருள் நாதம்	ஒலி என்பதன் பொருள் நாதம்
ஒழி என்பதன் பொருள் நாதம்	ஒலி என்பதன் பொருள் நாதம்
ஒளி என்பதன் பொருள் காற்று	ஒலி என்பதன் பொருள் காற்று
ஒழி என்பதன் பொருள் காற்று	ஒலி என்பதன் பொருள் காற்று
ஒலி என்பதன் பொருள் அழி	ஒழி என்பதன் பொருள் அழி
ஒளி என்பதன் பொருள் அழி	ஒழி என்பதன் பொருள் அழி
ஒலி என்பதன் பொருள் தவிர்	ஒழி என்பதன் பொருள் தவிர்
ஒளி என்பதன் பொருள் தவிர்	ஒழி என்பதன் பொருள் தவிர்
ஒலி என்பதன் பொருள் கொல்	ஒழி என்பதன் பொருள் கொல்
ஒளி என்பதன் பொருள் கொல்	ஒழி என்பதன் பொருள் கொல்
ஒலி என்பதன் பொருள் துற	ஒழி என்பதன் பொருள் துற
ஒளி என்பதன் பொருள் துற	ஒழி என்பதன் பொருள் துற
ஒலி என்பதன் பொருள் வெளிச்சம்	ஒளி என்பதன் பொருள் வெளிச்சம்
ஒழி என்பதன் பொருள் வெளிச்சம்	ஒளி என்பதன் பொருள் வெளிச்சம்
ஒலி என்பதன் பொருள் மறைத்து வை	ஒளி என்பதன் பொருள் மறைத்து வை
ஒழி என்பதன் பொருள் மறைத்து வை	ஒளி என்பதன் பொருள் மறைத்து வை
ஒள் என்பதன் பொருள் ஒலிக்குறிப்பு	ஒல் என்பதன் பொருள் ஒலிக்குறிப்பு
ஒல் என்பதன் பொருள் அழகு	ஒள் என்பதன் பொருள் அழகு
ஒல் என்பதன் பொருள் உண்மை	ஒள் என்பதன் பொருள் உண்மை
ஒல் என்பதன் பொருள் அறிவு	ஒள் என்பதன் பொருள் அறிவு
ஒல் என்பதன் பொருள் ஒளி	ஒள் என்பதன் பொருள் ஒளி
கழகம் என்பதன் பொருள் போர்	கலகம் என்பதன் பொருள் போர்
கழகம் என்பதன் பொருள் அமளி	கலகம் என்பதன் பொருள் அமளி
கழகம் என்பதன் பொருள் இரைச்சல்	கலகம் என்பதன் பொருள் இரைச்சல்
கலகம் என்பதன் பொருள் சங்கம்	கழகம் என்பதன் பொருள் சங்கம்
கலகம் என்பதன் பொருள் கூட்டமைப்பு	கழகம் என்பதன் பொருள் கூட்டமைப்பு
களங்கம் என்பதன் பொருள் கழங்கு	கழங்கம் என்பதன் பொருள் கழங்கு
களங்கம் என்பதன் பொருள் கழங்கு	கழங்கம் என்பதன் பொருள் கழங்கு
களங்கம் என்பதன் பொருள் விளையாட்டுக் கருவி	கழங்கம் என்பதன் பொருள் விளையாட்டுக் கருவி
களங்கம் என்பதன் பொருள் விளையாட்டுக் கருவி	கழங்கம் என்பதன் பொருள் விளையாட்டுக் கருவி
கழங்கம் என்பதன் பொருள் குற்றம்	களங்கம் என்பதன் பொருள் குற்றம்
கழங்கம் என்பதன் பொருள் குற்றம்	களங்கம் என்பதன் பொருள் குற்றம்
கழங்கம் என்பதன் பொருள் அழுக்கு	களங்கம் என்பதன் பொருள் அழுக்கு
கழங்கம் என்பதன் பொருள் அழுக்கு	களங்கம் என்பதன் பொருள் அழுக்கு
கழி என்பதன் பொருள் கலியுகம்	கலி என்பதன் பொருள் கலியுகம்
களி என்பதன் பொருள் கலியுகம்	கலி என்பதன் பொருள் கலியுகம்
கழி என்பதன் பொருள் பாவகை	கலி என்பதன் பொருள் பாவகை
களி என்பதன் பொருள் பாவகை	கலி என்பதன் பொருள் பாவகை
கழி என்பதன் பொருள் சனி	கலி என்பதன் பொருள் சனி
களி என்பதன் பொருள் சனி	கலி என்பதன் பொருள் சனி
கலி என்பதன் பொருள் கோல்	கழி என்பதன் பொருள் கோல்
களி என்பதன் பொருள் கோல்	கழி என்பதன் பொருள் கோல்
கலி என்பதன் பொருள் மிகுதி	கழி என்பதன் பொருள் மிகுதி
களி என்பதன் பொருள் மிகுதி	கழி என்பதன் பொருள் மிகுதி
கலி என்பதன் பொருள் உப்பளம்	கழி என்பதன் பொருள் உப்பளம்
களி என்பதன் பொருள் உப்பளம்	கழி என்பதன் பொருள் உப்பளம்
கலி என்பதன் பொருள் மகிழ்வு	களி என்பதன் பொருள் மகிழ்வு
கழி என்பதன் பொருள் மகிழ்வு	களி என்பதன் பொருள் மகிழ்வு
கலி என்பதன் பொருள் இன்பம்	களி என்பதன் பொருள் இன்பம்
கழி என்பதன் பொருள் இன்பம்	களி என்பதன் பொருள் இன்பம்
கழை என்பதன் பொருள் ஆண்மான்	கலை என்பதன் பொருள் ஆண்மான்
களை என்பதன் பொருள் ஆண்மான்	கலை என்பதன் பொருள் ஆண்மான்
கழை என்பதன் பொருள் சந்திரன்	கலை என்பதன் பொருள் சந்திரன்
களை என்பதன் பொருள் சந்திரன்	கலை என்பதன் பொருள் சந்திரன்
கழை என்பதன் பொருள் கல்வி	கலை என்பதன் பொருள் கல்வி
களை என்பதன் பொருள் கல்வி	கலை என்பதன் பொருள் கல்வி
கலை என்பதன் பொருள் மூங்கில்	கழை என்பதன் பொருள் மூங்கில்
களை என்பதன் பொருள் மூங்கில்	கழை என்பதன் பொருள் மூங்கில்
கலை என்பதன் பொருள் கரும்பு	கழை என்பதன் பொருள் கரும்பு
களை என்பதன் பொருள் கரும்பு	கழை என்பதன் பொருள் கரும்பு
கலை என்பதன் பொருள் புனர்பூசம்	கழை என்பதன் பொருள் புனர்பூசம்
களை என்பதன் பொருள் புனர்பூசம்	கழை என்பதன் பொருள் புனர்பூசம்
கழை என்பதன் பொருள் அழகு	களை என்பதன் பொருள் அழகு
கலை என்பதன் பொருள் அழகு	களை என்பதன் பொருள் அழகு
கழை என்பதன் பொருள் புல் பூண்டு	களை என்பதன் பொருள் புல் பூண்டு
கலை என்பதன் பொருள் புல் பூண்டு	களை என்பதன் பொருள் புல் பூண்டு
கழை என்பதன் பொருள் அயர்வு	களை என்பதன் பொருள் அயர்வு
கலை என்பதன் பொருள் அயர்வு	களை என்பதன் பொருள் அயர்வு
கள் என்பதன் பொருள் மலை	கல் என்பதன் பொருள் மலை
கள் என்பதன் பொருள் பாறை	கல் என்பதன் பொருள் பாறை
கள் என்பதன் பொருள் சிறுகல்	கல் என்பதன் பொருள் சிறுகல்
கல் என்பதன் பொருள் மது	கள் என்பதன் பொருள் மது
கல் என்பதன் பொருள் தேன்	கள் என்பதன் பொருள் தேன்
களம் என்பதன் பொருள் கப்பல்	கலம் என்பதன் பொருள் கப்பல்
களம் என்பதன் பொருள் கப்பல் பாத்திரம்	கலம் என்பதன் பொருள் கப்பல் பாத்திரம்
கலம் என்பதன் பொருள் இடம்	களம் என்பதன் பொருள் இடம்
கலம் என்பதன் பொருள் போர்க்களம்	களம் என்பதன் பொருள் போர்க்களம்
கலம் என்பதன் பொருள் இருள்	களம் என்பதன் பொருள் இருள்
காளி என்பதன் பொருள் ஒன்றுமில்லாதது	காலி என்பதன் பொருள் ஒன்றுமில்லாதது
காழி என்பதன் பொருள் ஒன்றுமில்லாதது	காலி என்பதன் பொருள் ஒன்றுமில்லாதது
காளி என்பதன் பொருள் வெற்றிடம்	காலி என்பதன் பொருள் வெற்றிடம்
காழி என்பதன் பொருள் வெற்றிடம்	காலி என்பதன் பொருள் வெற்றிடம்
காலி என்பதன் பொருள் துர்க்கை	காளி என்பதன் பொருள் துர்க்கை
காழி என்பதன் பொருள் துர்க்கை	காளி என்பதன் பொருள் துர்க்கை
காலி என்பதன் பொருள் மாயை	காளி என்பதன் பொருள் மாயை
காழி என்பதன் பொருள் மாயை	காளி என்பதன் பொருள் மாயை
காளி என்பதன் பொருள் சீர்காழி (ஊர்)	காழி என்பதன் பொருள் சீர்காழி (ஊர்)
காலி என்பதன் பொருள் சீர்காழி (ஊர்)	காழி என்பதன் பொருள் சீர்காழி (ஊர்)
காளை என்பதன் பொருள் பொழுது	காலை என்பதன் பொருள் பொழுது
காளை என்பதன் பொருள் விடியற்பொழுது	காலை என்பதன் பொருள் விடியற்பொழுது
காலை என்பதன் பொருள் காளைமாடு	காளை என்பதன் பொருள் காளைமாடு
காலை என்பதன் பொருள் இளைஞன்	காளை என்பதன் பொருள் இளைஞன்
காளம் என்பதன் பொருள் பொழுது	காலம் என்பதன் பொருள் பொழுது
காளம் என்பதன் பொருள் நேரம்	காலம் என்பதன் பொருள் நேரம்
காலம் என்பதன் பொருள் எட்டிமரம்	காளம் என்பதன் பொருள் எட்டிமரம்
காலம் என்பதன் பொருள் சூலம்	காளம் என்பதன் பொருள் சூலம்
கிழி என்பதன் பொருள் அச்சம்	கிலி என்பதன் பொருள் அச்சம்
கிளி என்பதன் பொருள் அச்சம்	கிலி என்பதன் பொருள் அச்சம்
கிழி என்பதன் பொருள் பயம்	கிலி என்பதன் பொருள் பயம்
கிளி என்பதன் பொருள் பயம்	கிலி என்பதன் பொருள் பயம்
கிளி என்பதன் பொருள் கிழித்துவிடு	கிழி என்பதன் பொருள் கிழித்துவிடு
கிலி என்பதன் பொருள் கிழித்துவிடு	கிழி என்பதன் பொருள் கிழித்துவிடு
கிளி என்பதன் பொருள் முடிப்பு (பொன்)	கிழி என்பதன் பொருள் முடிப்பு (பொன்)
கிலி என்பதன் பொருள் முடிப்பு (பொன்)	கிழி என்பதன் பொருள் முடிப்பு (பொன்)
கிலி என்பதன் பொருள் பறவை	கிளி என்பதன் பொருள் பறவை
கிழி என்பதன் பொருள் பறவை	கிளி என்பதன் பொருள் பறவை
கிலி என்பதன் பொருள் வெட்டுக்கிளி	கிளி என்பதன் பொருள் வெட்டுக்கிளி
கிழி என்பதன் பொருள் வெட்டுக்கிளி	கிளி என்பதன் பொருள் வெட்டுக்கிளி
கிளவி என்பதன் பொருள் முதியவள் 	கிழவி என்பதன் பொருள் முதியவள் 
கிளவி என்பதன் பொருள் மூதாட்டி	கிழவி என்பதன் பொருள் மூதாட்டி
கிழவி என்பதன் பொருள் சொல்	கிளவி என்பதன் பொருள் சொல்
கிழவி என்பதன் பொருள் மொழி	கிளவி என்பதன் பொருள் மொழி
குழி என்பதன் பொருள் மனைவி	குலி என்பதன் பொருள் மனைவி
குளி என்பதன் பொருள் மனைவி	குலி என்பதன் பொருள் மனைவி
குளி என்பதன் பொருள் பள்ளம்	குழி என்பதன் பொருள் பள்ளம்
குலி என்பதன் பொருள் பள்ளம்	குழி என்பதன் பொருள் பள்ளம்
குளி என்பதன் பொருள் பாத்தி	குழி என்பதன் பொருள் பாத்தி
குலி என்பதன் பொருள் பாத்தி	குழி என்பதன் பொருள் பாத்தி
குளி என்பதன் பொருள் பன்னீரடிச் சதுரம்	குழி என்பதன் பொருள் பன்னீரடிச் சதுரம்
குலி என்பதன் பொருள் பன்னீரடிச் சதுரம்	குழி என்பதன் பொருள் பன்னீரடிச் சதுரம்
குளி என்பதன் பொருள் வயிறு	குழி என்பதன் பொருள் வயிறு
குலி என்பதன் பொருள் வயிறு	குழி என்பதன் பொருள் வயிறு
குலி என்பதன் பொருள் நீராடு	குளி என்பதன் பொருள் நீராடு
குழி என்பதன் பொருள் நீராடு	குளி என்பதன் பொருள் நீராடு
குளம் என்பதன் பொருள் ஜாதியின் உட்பிரிவு	குலம் என்பதன் பொருள் ஜாதியின் உட்பிரிவு
குளம் என்பதன் பொருள் இனம்	குலம் என்பதன் பொருள் இனம்
குளம் என்பதன் பொருள் குடி	குலம் என்பதன் பொருள் குடி
குலம் என்பதன் பொருள் நீர்நிலை	குளம் என்பதன் பொருள் நீர்நிலை
குலம் என்பதன் பொருள் கண்மாய்	குளம் என்பதன் பொருள் கண்மாய்
குலம் என்பதன் பொருள் ஏரி	குளம் என்பதன் பொருள் ஏரி
குழை என்பதன் பொருள் கொத்து	குலை என்பதன் பொருள் கொத்து
குழை என்பதன் பொருள் மனம் தடுமாறுதல்	குலை என்பதன் பொருள் மனம் தடுமாறுதல்
குலை என்பதன் பொருள் குண்டலம்	குழை என்பதன் பொருள் குண்டலம்
குலை என்பதன் பொருள் குழைந்துபோதல்	குழை என்பதன் பொருள் குழைந்துபோதல்
குழவி என்பதன் பொருள் மகிழ்ந்திருத்தல்	குலவி என்பதன் பொருள் மகிழ்ந்திருத்தல்
குளவி என்பதன் பொருள் மகிழ்ந்திருத்தல்	குலவி என்பதன் பொருள் மகிழ்ந்திருத்தல்
குலவி என்பதன் பொருள் குழந்தை	குழவி என்பதன் பொருள் குழந்தை
குளவி என்பதன் பொருள் குழந்தை	குழவி என்பதன் பொருள் குழந்தை
குளவி என்பதன் பொருள் இளமை	குழவி என்பதன் பொருள் இளமை
குலவி என்பதன் பொருள் இளமை	குழவி என்பதன் பொருள் இளமை
குளவி என்பதன் பொருள் யானைக் கன்று 	குழவி என்பதன் பொருள் யானைக் கன்று 
குலவி என்பதன் பொருள் யானைக் கன்று 	குழவி என்பதன் பொருள் யானைக் கன்று 
குளவி என்பதன் பொருள் அம்மிக்கல்	குழவி என்பதன் பொருள் அம்மிக்கல்
குலவி என்பதன் பொருள் அம்மிக்கல்	குழவி என்பதன் பொருள் அம்மிக்கல்
குலவி ஒரு வண்டு	குளவி ஒரு வண்டு
குழவி ஒரு வண்டு	குளவி ஒரு வண்டு
குழவி என்பதன் பொருள் காட்டுமல்லி	குளவி என்பதன் பொருள் காட்டுமல்லி
குலவி என்பதன் பொருள் காட்டுமல்லி	குளவி என்பதன் பொருள் காட்டுமல்லி
குளிகம் என்பதன் பொருள் சிவப்பு	குலிகம் என்பதன் பொருள் சிவப்பு
குளிகம் என்பதன் பொருள் இலுப்பை	குலிகம் என்பதன் பொருள் இலுப்பை
குலிகம் என்பதன் பொருள் மருந்து	குளிகம் என்பதன் பொருள் மருந்து
குலிகம் என்பதன் பொருள் மாத்திரை	குளிகம் என்பதன் பொருள் மாத்திரை
குவளை என்பதன் பொருள் துளசி	குவலை என்பதன் பொருள் துளசி
குவளை என்பதன் பொருள் கஞ்சா	குவலை என்பதன் பொருள் கஞ்சா
குவலை என்பதன் பொருள் குவளை மலர்	குவளை என்பதன் பொருள் குவளை மலர்
குவலை என்பதன் பொருள் சொம்பு	குவளை என்பதன் பொருள் சொம்பு
குவலை என்பதன் பொருள் ஒரு பேரெண்	குவளை என்பதன் பொருள் ஒரு பேரெண்
கூளம் என்பதன் பொருள் தானியம்	கூலம் என்பதன் பொருள் தானியம்
கூளம் என்பதன் பொருள் கடைத்தெரு	கூலம் என்பதன் பொருள் கடைத்தெரு
கூலம் என்பதன் பொருள் குப்பை	கூளம் என்பதன் பொருள் குப்பை
கூளி என்பதன் பொருள் ஊதியம்	கூலி என்பதன் பொருள் ஊதியம்
கூலி என்பதன் பொருள் பேய்	கூளி என்பதன் பொருள் பேய்
கூலி என்பதன் பொருள் காளை	கூளி என்பதன் பொருள் காளை
கூலி என்பதன் பொருள் வீரர்	கூளி என்பதன் பொருள் வீரர்
கூலி என்பதன் பொருள் படைவீரர்	கூளி என்பதன் பொருள் படைவீரர்
கூலி என்பதன் பொருள் வணங்கி நிற்பவர்	கூளி என்பதன் பொருள் வணங்கி நிற்பவர்
கூலி என்பதன் பொருள் ஏவலாளர்	கூளி என்பதன் பொருள் ஏவலாளர்
கொழு என்பதன் பொருள் அரசசபை	கொலு என்பதன் பொருள் அரசசபை
கொளு என்பதன் பொருள் அரசசபை	கொலு என்பதன் பொருள் அரசசபை
கொழு என்பதன் பொருள் தெய்வசபை	கொலு என்பதன் பொருள் தெய்வசபை
கொளு என்பதன் பொருள் தெய்வசபை	கொலு என்பதன் பொருள் தெய்வசபை
கொழு என்பதன் பொருள் உல்லாசமாக வீற்றிருத்தல்	கொலு என்பதன் பொருள் உல்லாசமாக வீற்றிருத்தல்
கொளு என்பதன் பொருள் உல்லாசமாக வீற்றிருத்தல்	கொலு என்பதன் பொருள் உல்லாசமாக வீற்றிருத்தல்
கொளு என்பதன் பொருள் மழு	கொழு என்பதன் பொருள் மழு
கொலு என்பதன் பொருள் மழு	கொழு என்பதன் பொருள் மழு
கொலு என்பதன் பொருள் கொழுத்து இருத்தல்	கொழு என்பதன் பொருள் கொழுத்து இருத்தல்
கொளு என்பதன் பொருள் கொழுத்து இருத்தல்	கொழு என்பதன் பொருள் கொழுத்து இருத்தல்
கொளு என்பதன் பொருள் கலப்பையில் மாட்டும் பெரிய இரும்பு 	கொழு என்பதன் பொருள் கலப்பையில் மாட்டும் பெரிய இரும்பு 
கொலு என்பதன் பொருள் கலப்பையில் மாட்டும் பெரிய இரும்பு	கொழு என்பதன் பொருள் கலப்பையில் மாட்டும் பெரிய இரும்பு 
கொலு என்பதன் பொருள் புறப்பொருள் வெண்பாமாலைத் துறை 	கொளு என்பதன் பொருள் புறப்பொருள் வெண்பாமாலைத் துறை 
கொழு என்பதன் பொருள் புறப்பொருள் வெண்பாமாலைத் துறை 	கொளு என்பதன் பொருள் புறப்பொருள் வெண்பாமாலைத் துறை 
கொலு என்பதன் பொருள் பொருந்துவாய்	கொளு என்பதன் பொருள் பொருந்துவாய்
கொழு என்பதன் பொருள் பொருந்துவாய்	கொளு என்பதன் பொருள் பொருந்துவாய்
கொளை என்பதன் பொருள் கொல்லுதல்	கொலை என்பதன் பொருள் கொல்லுதல்
கொலை என்பதன் பொருள் கோட்பாடு	கொளை என்பதன் பொருள் கோட்பாடு
கொலை என்பதன் பொருள் பயன்	கொளை என்பதன் பொருள் பயன்
கொலை என்பதன் பொருள் இசைப்பாட்டு	கொளை என்பதன் பொருள் இசைப்பாட்டு
கொலை என்பதன் பொருள் தாளம்	கொளை என்பதன் பொருள் தாளம்
கொள்ளாமை என்பதன் பொருள் கொலை செய்யாமை	கொல்லாமை என்பதன் பொருள் கொலை செய்யாமை
கொல்லாமை என்பதன் பொருள் ஏற்றுக் கொள்ளாமை	கொள்ளாமை என்பதன் பொருள் ஏற்றுக் கொள்ளாமை
கொல்லாமை என்பதன் பொருள் அடங்காமை	கொள்ளாமை என்பதன் பொருள் அடங்காமை
கொள்ளி என்பதன் பொருள் உயிர்க்கொல்லி	கொல்லி என்பதன் பொருள் உயிர்க்கொல்லி
கொள்ளி ஒரு மலை	கொல்லி ஒரு மலை
கொல்லி என்பதன் பொருள் கொள்ளிக்கட்டை	கொள்ளி என்பதன் பொருள் கொள்ளிக்கட்டை
கொள்ளை என்பதன் பொருள் புழக்கடை	கொல்லை என்பதன் பொருள் புழக்கடை
கொள்ளை என்பதன் பொருள் தரிசுநிலம்	கொல்லை என்பதன் பொருள் தரிசுநிலம்
கொல்லை என்பதன் பொருள் திருடுதல்	கொள்ளை என்பதன் பொருள் திருடுதல்
கொல்லை என்பதன் பொருள் மிகுதி	கொள்ளை என்பதன் பொருள் மிகுதி
கோளம் என்பதன் பொருள் அழகு	கோலம் என்பதன் பொருள் அழகு
கோளம் என்பதன் பொருள் அலங்காரம்	கோலம் என்பதன் பொருள் அலங்காரம்
கோலம் என்பதன் பொருள் உருண்டை	கோளம் என்பதன் பொருள் உருண்டை
கோலம் என்பதன் பொருள் வட்டம்	கோளம் என்பதன் பொருள் வட்டம்
கோழை என்பதன் பொருள் மிளகு	கோலை என்பதன் பொருள் மிளகு
கோளை என்பதன் பொருள் மிளகு	கோலை என்பதன் பொருள் மிளகு
கோலை என்பதன் பொருள் வீரமற்றவன்	கோழை என்பதன் பொருள் வீரமற்றவன்
கோளை என்பதன் பொருள் வீரமற்றவன்	கோழை என்பதன் பொருள் வீரமற்றவன்
கோலை என்பதன் பொருள் கபம்	கோழை என்பதன் பொருள் கபம்
கோளை என்பதன் பொருள் கபம்	கோழை என்பதன் பொருள் கபம்
கோழை என்பதன் பொருள் குவளை	கோளை என்பதன் பொருள் குவளை
கோலை என்பதன் பொருள் குவளை	கோளை என்பதன் பொருள் குவளை
கோழை என்பதன் பொருள் எலி	கோளை என்பதன் பொருள் எலி
கோலை என்பதன் பொருள் எலி	கோளை என்பதன் பொருள் எலி
கோள் என்பதன் பொருள் மரக்கொம்பு	கோல் என்பதன் பொருள் மரக்கொம்பு
கோள் என்பதன் பொருள் அம்பு	கோல் என்பதன் பொருள் அம்பு
கோள் என்பதன் பொருள் குதிரைச்சம்மட்டி	கோல் என்பதன் பொருள் குதிரைச்சம்மட்டி
கோள் என்பதன் பொருள் தண்டு	கோல் என்பதன் பொருள் தண்டு
கோள் என்பதன் பொருள் யாழ்நரம்பு	கோல் என்பதன் பொருள் யாழ்நரம்பு
கோல் என்பதன் பொருள் கிரகம்	கோள் என்பதன் பொருள் கிரகம்
கோளி என்பதன் பொருள் இலந்தை	கோலி என்பதன் பொருள் இலந்தை
கோழி என்பதன் பொருள் இலந்தை	கோலி என்பதன் பொருள் இலந்தை
கோளி என்பதன் பொருள் விளையாடும் குண்டு	கோலி என்பதன் பொருள் விளையாடும் குண்டு
கோழி என்பதன் பொருள் விளையாடும் குண்டு	கோலி என்பதன் பொருள் விளையாடும் குண்டு
கோளி என்பதன் பொருள் உறையூர்	கோழி என்பதன் பொருள் உறையூர்
கோலி என்பதன் பொருள் உறையூர்	கோழி என்பதன் பொருள் உறையூர்
கோளி என்பதன் பொருள் விட்டில்	கோழி என்பதன் பொருள் விட்டில்
கோலி என்பதன் பொருள் விட்டில்	கோழி என்பதன் பொருள் விட்டில்
கோளி என்பதன் பொருள் பறவை	கோழி என்பதன் பொருள் பறவை
கோலி என்பதன் பொருள் பறவை	கோழி என்பதன் பொருள் பறவை
கோழி என்பதன் பொருள் பூவாது காய்க்கும் மரம்	கோளி என்பதன் பொருள் பூவாது காய்க்கும் மரம்
கோலி என்பதன் பொருள் பூவாது காய்க்கும் மரம்	கோளி என்பதன் பொருள் பூவாது காய்க்கும் மரம்
கோழி என்பதன் பொருள் ஆத்தி	கோளி என்பதன் பொருள் ஆத்தி
கோலி என்பதன் பொருள் ஆத்தி	கோளி என்பதன் பொருள் ஆத்தி
கோழி என்பதன் பொருள் ஆலம்	கோளி என்பதன் பொருள் ஆலம்
கோலி என்பதன் பொருள் ஆலம்	கோளி என்பதன் பொருள் ஆலம்
சளம் என்பதன் பொருள் நீர்	சலம் என்பதன் பொருள் நீர்
சளம் என்பதன் பொருள் சிறுநீர்	சலம் என்பதன் பொருள் சிறுநீர்
சளம் என்பதன் பொருள் குளிர்	சலம் என்பதன் பொருள் குளிர்
சலம் என்பதன் பொருள் பொய்	சளம் என்பதன் பொருள் பொய்
சலம் என்பதன் பொருள் துன்பம்	சளம் என்பதன் பொருள் துன்பம்
சலம் என்பதன் பொருள் வஞ்சனை	சளம் என்பதன் பொருள் வஞ்சனை
சாளை என்பதன் பொருள் பாடசாலை	சாலை என்பதன் பொருள் பாடசாலை
சாழை என்பதன் பொருள் பாடசாலை	சாலை என்பதன் பொருள் பாடசாலை
சாளை என்பதன் பொருள் பொது மண்டபம்	சாலை என்பதன் பொருள் பொது மண்டபம்
சாழை என்பதன் பொருள் பொது மண்டபம்	சாலை என்பதன் பொருள் பொது மண்டபம்
சாளை என்பதன் பொருள் அறக்கூடம்	சாலை என்பதன் பொருள் அறக்கூடம்
சாழை என்பதன் பொருள் அறக்கூடம்	சாலை என்பதன் பொருள் அறக்கூடம்
சாலை என்பதன் பொருள் கடல்மீன்	சாளை என்பதன் பொருள் கடல்மீன்
சாழை என்பதன் பொருள் கடல்மீன்	சாளை என்பதன் பொருள் கடல்மீன்
சாலை என்பதன் பொருள் குடிசை	சாழை என்பதன் பொருள் குடிசை
சாளை என்பதன் பொருள் குடிசை	சாழை என்பதன் பொருள் குடிசை
சாலை என்பதன் பொருள் குச்சு	சாழை என்பதன் பொருள் குச்சு
சாளை என்பதன் பொருள் குச்சு	சாழை என்பதன் பொருள் குச்சு
சுளித்தல் என்பதன் பொருள் சுழலுதல்	சுழித்தல் என்பதன் பொருள் சுழலுதல்
சுளித்தல் என்பதன் பொருள் நீர்ச்சுழல்	சுழித்தல் என்பதன் பொருள் நீர்ச்சுழல்
சுழித்தல் என்பதன் பொருள் முறித்தல்	சுளித்தல் என்பதன் பொருள் முறித்தல்
சுழித்தல் என்பதன் பொருள் சினத்தல்	சுளித்தல் என்பதன் பொருள் சினத்தல்
சூளை என்பதன் பொருள் வயிற்று நோய்	சூலை என்பதன் பொருள் வயிற்று நோய்
சூலை என்பதன் பொருள் செங்கல் சூளை	சூளை என்பதன் பொருள் செங்கல் சூளை
சூழ் என்பதன் பொருள் கர்ப்பம்	சூல் என்பதன் பொருள் கர்ப்பம்
சூள் என்பதன் பொருள் கர்ப்பம்	சூல் என்பதன் பொருள் கர்ப்பம்
சூள் என்பதன் பொருள் சூழ்ந்துகொள்	சூழ் என்பதன் பொருள் சூழ்ந்துகொள்
சூல் என்பதன் பொருள் சூழ்ந்துகொள்	சூழ் என்பதன் பொருள் சூழ்ந்துகொள்
சூள் என்பதன் பொருள் சுற்று	சூழ் என்பதன் பொருள் சுற்று
சூல் என்பதன் பொருள் சுற்று	சூழ் என்பதன் பொருள் சுற்று
சூல் என்பதன் பொருள் சபதம்	சூள் என்பதன் பொருள் சபதம்
சூழ் என்பதன் பொருள் சபதம்	சூள் என்பதன் பொருள் சபதம்
சேள் என்பதன் பொருள் மீன்	சேல் என்பதன் பொருள் மீன்
சேல் என்பதன் பொருள் மேலிடம்	சேள் என்பதன் பொருள் மேலிடம்
சோழி என்பதன் பொருள் ரவிக்கை	சோலி என்பதன் பொருள் ரவிக்கை
சோளி என்பதன் பொருள் ரவிக்கை	சோலி என்பதன் பொருள் ரவிக்கை
சோழி என்பதன் பொருள் காரியம்	சோலி என்பதன் பொருள் காரியம்
சோளி என்பதன் பொருள் காரியம்	சோலி என்பதன் பொருள் காரியம்
சோளி என்பதன் பொருள் பலகரை	சோழி என்பதன் பொருள் பலகரை
சோலி என்பதன் பொருள் பலகரை	சோழி என்பதன் பொருள் பலகரை
சோலி என்பதன் பொருள் கூடைவகை	சோளி என்பதன் பொருள் கூடைவகை
சோழி என்பதன் பொருள் கூடைவகை	சோளி என்பதன் பொருள் கூடைவகை
தவலை என்பதன் பொருள் ஓர் உயிரி	தவளை என்பதன் பொருள் ஓர் உயிரி
தவளை என்பதன் பொருள் பாத்திரம்	தவலை என்பதன் பொருள் பாத்திரம்
தழம் என்பதன் பொருள் இடம்	தலம் என்பதன் பொருள் இடம்
தளம் என்பதன் பொருள் இடம்	தலம் என்பதன் பொருள் இடம்
தழம் என்பதன் பொருள் பூமி	தலம் என்பதன் பொருள் பூமி
தளம் என்பதன் பொருள் பூமி	தலம் என்பதன் பொருள் பூமி
தளம் என்பதன் பொருள் தைலம்	தழம் என்பதன் பொருள் தைலம்
தலம் என்பதன் பொருள் தைலம்	தழம் என்பதன் பொருள் தைலம்
தலம் என்பதன் பொருள் மேடை	தளம் என்பதன் பொருள் மேடை
தழம் என்பதன் பொருள் மேடை	தளம் என்பதன் பொருள் மேடை
தழம் என்பதன் பொருள் மாடி வீட்டின் அடுக்கு	தளம் என்பதன் பொருள் மாடி வீட்டின் அடுக்கு
தலம் என்பதன் பொருள் மாடி வீட்டின் அடுக்கு	தளம் என்பதன் பொருள் மாடி வீட்டின் அடுக்கு
தளை என்பதன் பொருள் தாவர உறுப்பு	தழை என்பதன் பொருள் தாவர உறுப்பு
தலை என்பதன் பொருள் தாவர உறுப்பு	தழை என்பதன் பொருள் தாவர உறுப்பு
தளை என்பதன் பொருள் மண்டை	தலை என்பதன் பொருள் மண்டை
தழை என்பதன் பொருள் மண்டை	தலை என்பதன் பொருள் மண்டை
தலை என்பதன் பொருள் விலங்கு	தளை என்பதன் பொருள் விலங்கு
தழை என்பதன் பொருள் விலங்கு	தளை என்பதன் பொருள் விலங்கு
தாளம் என்பதன் பொருள் உலகம்	தாலம் என்பதன் பொருள் உலகம்
தாளம் என்பதன் பொருள் தேன்	தாலம் என்பதன் பொருள் தேன்
தாலம் என்பதன் பொருள் இசைக்கருவி	தாளம் என்பதன் பொருள் இசைக்கருவி
தாலம் என்பதன் பொருள் ஜதி	தாளம் என்பதன் பொருள் ஜதி
தாழி என்பதன் பொருள் மங்கலநாண்	தாலி என்பதன் பொருள் மங்கலநாண்
தாளி என்பதன் பொருள் மங்கலநாண்	தாலி என்பதன் பொருள் மங்கலநாண்
தாளி என்பதன் பொருள் கடல்	தாழி என்பதன் பொருள் கடல்
தாலி என்பதன் பொருள் கடல்	தாழி என்பதன் பொருள் கடல்
தாளி என்பதன் பொருள் குடம்	தாழி என்பதன் பொருள் குடம்
தாலி என்பதன் பொருள் குடம்	தாழி என்பதன் பொருள் குடம்
தாளி என்பதன் பொருள் பரணி 	தாழி என்பதன் பொருள் பரணி 
தாலி என்பதன் பொருள் பரணி 	தாழி என்பதன் பொருள் பரணி 
தாளி என்பதன் பொருள் பெரியபாண்டம்	தாழி என்பதன் பொருள் பெரியபாண்டம்
தாலி என்பதன் பொருள் பெரியபாண்டம்	தாழி என்பதன் பொருள் பெரியபாண்டம்
தாலி என்பதன் பொருள் தாளித்தல்	தாளி என்பதன் பொருள் தாளித்தல்
தாழி என்பதன் பொருள் தாளித்தல்	தாளி என்பதன் பொருள் தாளித்தல்
தாலி என்பதன் பொருள் நாக்கு	தாளி என்பதன் பொருள் நாக்கு
தாழி என்பதன் பொருள் நாக்கு	தாளி என்பதன் பொருள் நாக்கு
தாலி என்பதன் பொருள் தாலாட்டு	தாளி என்பதன் பொருள் தாலாட்டு
தாழி என்பதன் பொருள் தாலாட்டு	தாளி என்பதன் பொருள் தாலாட்டு
தாள் என்பதன் பொருள் தாழ்தல்	தாழ் என்பதன் பொருள் தாழ்தல்
தாள் என்பதன் பொருள் குனிதல்	தாழ் என்பதன் பொருள் குனிதல்
தாழ் என்பதன் பொருள் முயற்சி	தாள் என்பதன் பொருள் முயற்சி
தாழ் என்பதன் பொருள் பாதம்	தாள் என்பதன் பொருள் பாதம்
தாழ் என்பதன் பொருள் ஆதி	தாள் என்பதன் பொருள் ஆதி
தாழ் என்பதன் பொருள் படி	தாள் என்பதன் பொருள் படி
தாழ் என்பதன் பொருள் காகிதம்	தாள் என்பதன் பொருள் காகிதம்
துளக்கம் என்பதன் பொருள் ஒளி	துலக்கம் என்பதன் பொருள் ஒளி
துளக்கம் என்பதன் பொருள் தெளிவு	துலக்கம் என்பதன் பொருள் தெளிவு
துலக்கம் என்பதன் பொருள் அசைவு	துளக்கம் என்பதன் பொருள் அசைவு
துலக்கம் என்பதன் பொருள் வருத்தம்	துளக்கம் என்பதன் பொருள் வருத்தம்
துலக்கம் என்பதன் பொருள் கலக்கம்	துளக்கம் என்பதன் பொருள் கலக்கம்
துலக்கம் என்பதன் பொருள் ஒளி	துளக்கம் என்பதன் பொருள் ஒளி
துளம் என்பதன் பொருள் கோரை	துலம் என்பதன் பொருள் கோரை
துளம் என்பதன் பொருள் கனம்	துலம் என்பதன் பொருள் கனம்
துலம் என்பதன் பொருள் மாதுளை	துளம் என்பதன் பொருள் மாதுளை
துலம் என்பதன் பொருள் மயிலிறகு	துளம் என்பதன் பொருள் மயிலிறகு
துழி என்பதன் பொருள் பெண் ஆமை	துலி என்பதன் பொருள் பெண் ஆமை
துளி என்பதன் பொருள் பெண் ஆமை	துலி என்பதன் பொருள் பெண் ஆமை
துளி என்பதன் பொருள் பள்ளம்	துழி என்பதன் பொருள் பள்ளம்
துலி என்பதன் பொருள் பள்ளம்	துழி என்பதன் பொருள் பள்ளம்
துழி என்பதன் பொருள் மழைத்துளி	துளி என்பதன் பொருள் மழைத்துளி
துலி என்பதன் பொருள் மழைத்துளி	துளி என்பதன் பொருள் மழைத்துளி
துழி என்பதன் பொருள் திவலை	துளி என்பதன் பொருள் திவலை
துலி என்பதன் பொருள் திவலை	துளி என்பதன் பொருள் திவலை
துழி என்பதன் பொருள் சிறிய அளவு	துளி என்பதன் பொருள் சிறிய அளவு
துலி என்பதன் பொருள் சிறிய அளவு	துளி என்பதன் பொருள் சிறிய அளவு
துளை என்பதன் பொருள் ஒப்பு	துலை என்பதன் பொருள் ஒப்பு
துளை என்பதன் பொருள் கனம்	துலை என்பதன் பொருள் கனம்
துலை என்பதன் பொருள் துவாரம்	துளை என்பதன் பொருள் துவாரம்
துலை என்பதன் பொருள் வாயில்	துளை என்பதன் பொருள் வாயில்
தூளி என்பதன் பொருள் எழுதுகோல்	தூலி என்பதன் பொருள் எழுதுகோல்
தூளி என்பதன் பொருள் எழுத்தாணி	தூலி என்பதன் பொருள் எழுத்தாணி
தூலி என்பதன் பொருள் புழுதி	தூளி என்பதன் பொருள் புழுதி
தூலி என்பதன் பொருள் குதிரை	தூளி என்பதன் பொருள் குதிரை
தெளித்தல் என்பதன் பொருள் கோபித்தல்	தெழித்தல் என்பதன் பொருள் கோபித்தல்
தெளித்தல் என்பதன் பொருள் முழங்குதல்	தெழித்தல் என்பதன் பொருள் முழங்குதல்
தெளித்தல் என்பதன் பொருள் அதட்டுதல்	தெழித்தல் என்பதன் பொருள் அதட்டுதல்
தெளித்தல் என்பதன் பொருள் நீக்குதல்	தெழித்தல் என்பதன் பொருள் நீக்குதல்
தெளித்தல் என்பதன் பொருள் ஆரவாரித்தல்	தெழித்தல் என்பதன் பொருள் ஆரவாரித்தல்
தெழித்தல் என்பதன் பொருள் விதைத்தல்	தெளித்தல் என்பதன் பொருள் விதைத்தல்
தெழித்தல் என்பதன் பொருள் சபதம்	தெளித்தல் என்பதன் பொருள் சபதம்
தெழித்தல் என்பதன் பொருள் கூறல்	தெளித்தல் என்பதன் பொருள் கூறல்
தெள் என்பதன் பொருள் அஞ்சுதல்	தெல் என்பதன் பொருள் அஞ்சுதல்
தெல் என்பதன் பொருள் தெளிவான	தெள் என்பதன் பொருள் தெளிவான
தோழன் என்பதன் பொருள் அற்பன்	தோலன் என்பதன் பொருள் அற்பன்
தோலன் என்பதன் பொருள் நண்பன்	தோழன் என்பதன் பொருள் நண்பன்
தோழி என்பதன் பொருள் பிசின்	தோலி என்பதன் பொருள் பிசின்
தோளி என்பதன் பொருள் பிசின்	தோலி என்பதன் பொருள் பிசின்
தோழி என்பதன் பொருள் ஒருவகை மீன்	தோலி என்பதன் பொருள் ஒருவகை மீன்
தோளி என்பதன் பொருள் ஒருவகை மீன்	தோலி என்பதன் பொருள் ஒருவகை மீன்
தோளி என்பதன் பொருள் பாங்கி	தோழி என்பதன் பொருள் பாங்கி
தோலி என்பதன் பொருள் பாங்கி	தோழி என்பதன் பொருள் பாங்கி
தோளி என்பதன் பொருள் நட்பால் நெருக்கமானவள்	தோழி என்பதன் பொருள் நட்பால் நெருக்கமானவள்
தோலி என்பதன் பொருள் நட்பால் நெருக்கமானவள்	தோழி என்பதன் பொருள் நட்பால் நெருக்கமானவள்
தோலி என்பதன் பொருள் அவுரி, ஒருவகை குத்துச்செடி	தோளி என்பதன் பொருள் அவுரி, ஒருவகை குத்துச்செடி
தோழி என்பதன் பொருள் அவுரி, ஒருவகை குத்துச்செடி	தோளி என்பதன் பொருள் அவுரி, ஒருவகை குத்துச்செடி
தோலி என்பதன் பொருள் அரக்கு	தோளி என்பதன் பொருள் அரக்கு
தோழி என்பதன் பொருள் அரக்கு	தோளி என்பதன் பொருள் அரக்கு
தோள் என்பதன் பொருள் சருமம்	தோல் என்பதன் பொருள் சருமம்
தோள் என்பதன் பொருள் வனப்பு	தோல் என்பதன் பொருள் வனப்பு
தோள் என்பதன் பொருள் விதையின் மேல்பகுதி	தோல் என்பதன் பொருள் விதையின் மேல்பகுதி
தோல் என்பதன் பொருள் புயம்	தோள் என்பதன் பொருள் புயம்
தோல் என்பதன் பொருள் வீரம்	தோள் என்பதன் பொருள் வீரம்
நளன் என்பதன் பொருள் நலம்	நலன் என்பதன் பொருள் நலம்
நளன் என்பதன் பொருள் அழகு	நலன் என்பதன் பொருள் அழகு
நளன் என்பதன் பொருள் புகழ்	நலன் என்பதன் பொருள் புகழ்
நளன் என்பதன் பொருள் இன்பம்	நலன் என்பதன் பொருள் இன்பம்
நளன் என்பதன் பொருள் நன்மை	நலன் என்பதன் பொருள் நன்மை
நளன் என்பதன் பொருள் குணம்	நலன் என்பதன் பொருள் குணம்
நலன் என்பதன் பொருள் தமயந்தியின் கணவன்	நளன் என்பதன் பொருள் தமயந்தியின் கணவன்
நலன் என்பதன் பொருள் ஓர் அரசன்	நளன் என்பதன் பொருள் ஓர் அரசன்
நளி என்பதன் பொருள் நோய்	நலி என்பதன் பொருள் நோய்
நலி என்பதன் பொருள் குளிர்ச்சி	நளி என்பதன் பொருள் குளிர்ச்சி
நலி என்பதன் பொருள் பெருமை	நளி என்பதன் பொருள் பெருமை
நளிதல் என்பதன் பொருள் நலிந்துபோதல்	நலிதல் என்பதன் பொருள் நலிந்துபோதல்
நளிதல் என்பதன் பொருள் தோற்றல்	நலிதல் என்பதன் பொருள் தோற்றல்
நலிதல் என்பதன் பொருள் செறிதல்	நளிதல் என்பதன் பொருள் செறிதல்
நலிதல் என்பதன் பொருள் பரத்தல்	நளிதல் என்பதன் பொருள் பரத்தல்
நலிதல் என்பதன் பொருள் ஒத்தல்	நளிதல் என்பதன் பொருள் ஒத்தல்
நள் என்பதன் பொருள் நல்ல	நல் என்பதன் பொருள் நல்ல
நல் என்பதன் பொருள் இரவு	நள் என்பதன் பொருள் இரவு
நல் என்பதன் பொருள் நடு	நள் என்பதன் பொருள் நடு
நல் என்பதன் பொருள் நள்ளிரவு	நள் என்பதன் பொருள் நள்ளிரவு
நாழம் என்பதன் பொருள் பூவின் காம்பு	நாலம் என்பதன் பொருள் பூவின் காம்பு
நாளம் என்பதன் பொருள் பூவின் காம்பு	நாலம் என்பதன் பொருள் பூவின் காம்பு
நாளம் என்பதன் பொருள் இழிவுரை	நாழம் என்பதன் பொருள் இழிவுரை
நாலம் என்பதன் பொருள் இழிவுரை	நாழம் என்பதன் பொருள் இழிவுரை
நாளம் என்பதன் பொருள் வசவு	நாழம் என்பதன் பொருள் வசவு
நாலம் என்பதன் பொருள் வசவு	நாழம் என்பதன் பொருள் வசவு
நாலம் என்பதன் பொருள் பூந்தண்டு	நாளம் என்பதன் பொருள் பூந்தண்டு
நாழம் என்பதன் பொருள் பூந்தண்டு	நாளம் என்பதன் பொருள் பூந்தண்டு
நாலம் என்பதன் பொருள் உட்துளை	நாளம் என்பதன் பொருள் உட்துளை
நாழம் என்பதன் பொருள் உட்துளை	நாளம் என்பதன் பொருள் உட்துளை
நாலம் என்பதன் பொருள் ரத்தநாளம்	நாளம் என்பதன் பொருள் ரத்தநாளம்
நாழம் என்பதன் பொருள் ரத்தநாளம்	நாளம் என்பதன் பொருள் ரத்தநாளம்
நாளி என்பதன் பொருள் முத்து	நாலி என்பதன் பொருள் முத்து
நாழி என்பதன் பொருள் முத்து	நாலி என்பதன் பொருள் முத்து
நாளி என்பதன் பொருள் கந்தை ஆடை	நாலி என்பதன் பொருள் கந்தை ஆடை
நாழி என்பதன் பொருள் கந்தை ஆடை	நாலி என்பதன் பொருள் கந்தை ஆடை
நாழி என்பதன் பொருள் கல்	நாளி என்பதன் பொருள் கல்
நாலி என்பதன் பொருள் கல்	நாளி என்பதன் பொருள் கல்
நாழி என்பதன் பொருள் நாய்	நாளி என்பதன் பொருள் நாய்
நாலி என்பதன் பொருள் நாய்	நாளி என்பதன் பொருள் நாய்
நாலி என்பதன் பொருள் உள்தொளையுள்ள பொருள்	நாழி என்பதன் பொருள் உள்தொளையுள்ள பொருள்
நாளி என்பதன் பொருள் உள்தொளையுள்ள பொருள்	நாழி என்பதன் பொருள் உள்தொளையுள்ள பொருள்
நாலி என்பதன் பொருள் ஒருபடி	நாழி என்பதன் பொருள் ஒருபடி
நாளி என்பதன் பொருள் ஒருபடி	நாழி என்பதன் பொருள் ஒருபடி
நாலி என்பதன் பொருள் ஏர்	நாழி என்பதன் பொருள் ஏர்
நாளி என்பதன் பொருள் ஏர்	நாழி என்பதன் பொருள் ஏர்
நாலி என்பதன் பொருள் அம்பறாத்துணி	நாழி என்பதன் பொருள் அம்பறாத்துணி
நாளி என்பதன் பொருள் அம்பறாத்துணி	நாழி என்பதன் பொருள் அம்பறாத்துணி
நாலி என்பதன் பொருள் நாடா	நாழி என்பதன் பொருள் நாடா
நாளி என்பதன் பொருள் நாடா	நாழி என்பதன் பொருள் நாடா
நாலி என்பதன் பொருள் பூரட்டாதி	நாழி என்பதன் பொருள் பூரட்டாதி
நாளி என்பதன் பொருள் பூரட்டாதி	நாழி என்பதன் பொருள் பூரட்டாதி
நாழிகை என்பதன் பொருள் மூங்கில்	நாலிகை என்பதன் பொருள் மூங்கில்
நாழிகை என்பதன் பொருள் அடுப்புச்சந்து	நாலிகை என்பதன் பொருள் அடுப்புச்சந்து
நாலிகை என்பதன் பொருள் வட்டம்	நாழிகை என்பதன் பொருள் வட்டம்
நாலிகை என்பதன் பொருள் கடிகாரம்	நாழிகை என்பதன் பொருள் கடிகாரம்
நாழ் என்பதன் பொருள் நான்கு	நால் என்பதன் பொருள் நான்கு
நாள் என்பதன் பொருள் நான்கு	நால் என்பதன் பொருள் நான்கு
நாள் என்பதன் பொருள் குற்றம்	நாழ் என்பதன் பொருள் குற்றம்
நால் என்பதன் பொருள் குற்றம்	நாழ் என்பதன் பொருள் குற்றம்
நாள் என்பதன் பொருள் செருக்கு	நாழ் என்பதன் பொருள் செருக்கு
நால் என்பதன் பொருள் செருக்கு	நாழ் என்பதன் பொருள் செருக்கு
நால் என்பதன் பொருள் காலம்	நாள் என்பதன் பொருள் காலம்
நாழ் என்பதன் பொருள் காலம்	நாள் என்பதன் பொருள் காலம்
நால் என்பதன் பொருள் திதி	நாள் என்பதன் பொருள் திதி
நாழ் என்பதன் பொருள் திதி	நாள் என்பதன் பொருள் திதி
நீளம் என்பதன் பொருள் ஒரு நிறம்	நீலம் என்பதன் பொருள் ஒரு நிறம்
நீளம் என்பதன் பொருள் கருங்குவளை	நீலம் என்பதன் பொருள் கருங்குவளை
நீளம் என்பதன் பொருள் இருள்	நீலம் என்பதன் பொருள் இருள்
நீலம் என்பதன் பொருள் நெடுமை 	நீளம் என்பதன் பொருள் நெடுமை 
நீலம் என்பதன் பொருள் நீண்ட	நீளம் என்பதன் பொருள் நீண்ட
நீலம் என்பதன் பொருள் தாமதம்	நீளம் என்பதன் பொருள் தாமதம்
நீள் என்பதன் பொருள் நீலம்	நீல் என்பதன் பொருள் நீலம்
நீள் என்பதன் பொருள் காற்று	நீல் என்பதன் பொருள் காற்று
நீல் என்பதன் பொருள் நீளம்	நீள் என்பதன் பொருள் நீளம்
நீல் என்பதன் பொருள் ஒளி	நீள் என்பதன் பொருள் ஒளி
பழம் என்பதன் பொருள் கிழங்கு	பலம் என்பதன் பொருள் கிழங்கு
பழம் என்பதன் பொருள் வலி	பலம் என்பதன் பொருள் வலி
பழம் என்பதன் பொருள் நெற்றி	பலம் என்பதன் பொருள் நெற்றி
பழம் என்பதன் பொருள் சக்தி	பலம் என்பதன் பொருள் சக்தி
பழம் என்பதன் பொருள் சேனை	பலம் என்பதன் பொருள் சேனை
பழம் என்பதன் பொருள் வன்மை	பலம் என்பதன் பொருள் வன்மை
பழம் என்பதன் பொருள் உறுதி	பலம் என்பதன் பொருள் உறுதி
பழம் என்பதன் பொருள் எடை	பலம் என்பதன் பொருள் எடை
பலம் என்பதன் பொருள் கனி	பழம் என்பதன் பொருள் கனி
பலம் என்பதன் பொருள் முதுமை	பழம் என்பதன் பொருள் முதுமை
பள்ளி என்பதன் பொருள் சிற்றூர்	பல்லி என்பதன் பொருள் சிற்றூர்
பள்ளி என்பதன் பொருள் இடையர் ஊர்	பல்லி என்பதன் பொருள் இடையர் ஊர்
பள்ளி என்பதன் பொருள் உழுகருவி	பல்லி என்பதன் பொருள் உழுகருவி
பள்ளி என்பதன் பொருள் ஓர் உயிரி	பல்லி என்பதன் பொருள் ஓர் உயிரி
பள்ளி என்பதன் பொருள் வண்டியுறுப்பு	பல்லி என்பதன் பொருள் வண்டியுறுப்பு
பல்லி என்பதன் பொருள் இடைச்சேரி	பள்ளி என்பதன் பொருள் இடைச்சேரி
பல்லி என்பதன் பொருள் புத்தர் கோயில்	பள்ளி என்பதன் பொருள் புத்தர் கோயில்
பல்லி என்பதன் பொருள் குறும்பன்	பள்ளி என்பதன் பொருள் குறும்பன்
பல்லி என்பதன் பொருள் மருதநிலத்தூர்	பள்ளி என்பதன் பொருள் மருதநிலத்தூர்
பல்லி என்பதன் பொருள் படுக்கை	பள்ளி என்பதன் பொருள் படுக்கை
பல்லி என்பதன் பொருள் பள்ளிக்கூடம்	பள்ளி என்பதன் பொருள் பள்ளிக்கூடம்
பழி என்பதன் பொருள் பலியிடுதல்	பலி என்பதன் பொருள் பலியிடுதல்
பழி என்பதன் பொருள் பலியுயிர்	பலி என்பதன் பொருள் பலியுயிர்
பலி என்பதன் பொருள் குற்றம்	பழி என்பதன் பொருள் குற்றம்
பாழ் என்பதன் பொருள் திரவ உணவு	பால் என்பதன் பொருள் திரவ உணவு
பாழ் என்பதன் பொருள் பகுப்பு	பால் என்பதன் பொருள் பகுப்பு
பாழ் என்பதன் பொருள் இயல்பு	பால் என்பதன் பொருள் இயல்பு
பால் என்பதன் பொருள் வீண்	பாழ் என்பதன் பொருள் வீண்
பால் என்பதன் பொருள் வெறுமை	பாழ் என்பதன் பொருள் வெறுமை
பீளை என்பதன் பொருள் துன்பம்	பீழை என்பதன் பொருள் துன்பம்
பீழை என்பதன் பொருள் கண் அழுக்கு	பீளை என்பதன் பொருள் கண் அழுக்கு
புளி என்பதன் பொருள் காட்டு விலங்கு	புலி என்பதன் பொருள் காட்டு விலங்கு
புலி என்பதன் பொருள் புளியமரம்	புளி என்பதன் பொருள் புளியமரம்
புலி என்பதன் பொருள் புளியங்காய்	புளி என்பதன் பொருள் புளியங்காய்
புழை என்பதன் பொருள் புலால்	புலை என்பதன் பொருள் புலால்
புழை என்பதன் பொருள் ஊன்	புலை என்பதன் பொருள் ஊன்
புழை என்பதன் பொருள் கீழ்மை	புலை என்பதன் பொருள் கீழ்மை
புலை என்பதன் பொருள் துளை	புழை என்பதன் பொருள் துளை
புலை என்பதன் பொருள் வாயில்	புழை என்பதன் பொருள் வாயில்
புலை என்பதன் பொருள் நரகம்	புழை என்பதன் பொருள் நரகம்
புகழ் என்பதன் பொருள் அடைக்கலம்	புகல் என்பதன் பொருள் அடைக்கலம்
புகல் என்பதன் பொருள் பெருமை	புகழ் என்பதன் பொருள் பெருமை
புள் என்பதன் பொருள் அற்பம்	புல் என்பதன் பொருள் அற்பம்
புள் என்பதன் பொருள் கலவி	புல் என்பதன் பொருள் கலவி
புள் என்பதன் பொருள் புல்பூண்டு	புல் என்பதன் பொருள் புல்பூண்டு
புல் என்பதன் பொருள் பறவை	புள் என்பதன் பொருள் பறவை
பூளம் என்பதன் பொருள் புற்கட்டு	பூலம் என்பதன் பொருள் புற்கட்டு
பூலம் என்பதன் பொருள் பூவரசு	பூளம் என்பதன் பொருள் பூவரசு
பூளை என்பதன் பொருள் துவாரம்	பூழை என்பதன் பொருள் துவாரம்
பூளை என்பதன் பொருள் கோபுரவாயில்	பூழை என்பதன் பொருள் கோபுரவாயில்
பூழை என்பதன் பொருள் பூளைச்செடி	பூளை என்பதன் பொருள் பூளைச்செடி
பூழை என்பதன் பொருள் இலவம் பஞ்சு	பூளை என்பதன் பொருள் இலவம் பஞ்சு
பாழி என்பதன் பொருள் தானியக் குவியல்	பாலி என்பதன் பொருள் தானியக் குவியல்
பாளி என்பதன் பொருள் தானியக் குவியல்	பாலி என்பதன் பொருள் தானியக் குவியல்
பாழி என்பதன் பொருள் தூற்றாத தானியம்	பாலி என்பதன் பொருள் தூற்றாத தானியம்
பாளி என்பதன் பொருள் தூற்றாத தானியம்	பாலி என்பதன் பொருள் தூற்றாத தானியம்
பாளி என்பதன் பொருள் கொடுத்தல்	பாழி என்பதன் பொருள் கொடுத்தல்
பாலி என்பதன் பொருள் கொடுத்தல்	பாழி என்பதன் பொருள் கொடுத்தல்
பாளி என்பதன் பொருள் ஈதல்	பாழி என்பதன் பொருள் ஈதல்
பாலி என்பதன் பொருள் ஈதல்	பாழி என்பதன் பொருள் ஈதல்
பாழி என்பதன் பொருள் வரப்பு	பாளி என்பதன் பொருள் வரப்பு
பாலி என்பதன் பொருள் வரப்பு	பாளி என்பதன் பொருள் வரப்பு
பாழி என்பதன் பொருள் எல்லை	பாளி என்பதன் பொருள் எல்லை
பாலி என்பதன் பொருள் எல்லை	பாளி என்பதன் பொருள் எல்லை
பாழிவு என்பதன் பொருள் அழகு	பாலிவு என்பதன் பொருள் அழகு
பாழிவு என்பதன் பொருள் நிறைவு	பாலிவு என்பதன் பொருள் நிறைவு
பாலிவு என்பதன் பொருள் பொழிதல்	பாழிவு என்பதன் பொருள் பொழிதல்
பாலிவு என்பதன் பொருள் மேன்மை	பாழிவு என்பதன் பொருள் மேன்மை
போளி என்பதன் பொருள் பொய்	போலி என்பதன் பொருள் பொய்
போளி என்பதன் பொருள் வஞ்சகம்	போலி என்பதன் பொருள் வஞ்சகம்
போளி என்பதன் பொருள் ஒப்பு	போலி என்பதன் பொருள் ஒப்பு
போலி என்பதன் பொருள் இனிப்புப் பண்டம்	போளி என்பதன் பொருள் இனிப்புப் பண்டம்
பொழிதல் என்பதன் பொருள் செழித்தல்	பொலிதல் என்பதன் பொருள் செழித்தல்
பொழிதல் என்பதன் பொருள் மங்கலமாதல்	பொலிதல் என்பதன் பொருள் மங்கலமாதல்
பொலிதல் என்பதன் பொருள் ஈதல்	பொழிதல் என்பதன் பொருள் ஈதல்
பொலிதல் என்பதன் பொருள் கொடுத்தல்	பொழிதல் என்பதன் பொருள் கொடுத்தல்
பொலிதல் என்பதன் பொருள் சொரிதல்	பொழிதல் என்பதன் பொருள் சொரிதல்
பொலிதல் என்பதன் பொருள் பெய்தல்	பொழிதல் என்பதன் பொருள் பெய்தல்
பொலிதல் என்பதன் பொருள் நிறைதல்	பொழிதல் என்பதன் பொருள் நிறைதல்
மழம் என்பதன் பொருள் அழுக்கு	மலம் என்பதன் பொருள் அழுக்கு
மழம் என்பதன் பொருள் பாவம்	மலம் என்பதன் பொருள் பாவம்
மலம் என்பதன் பொருள் இளமை	மழம் என்பதன் பொருள் இளமை
மலம் என்பதன் பொருள் குழந்தை	மழம் என்பதன் பொருள் குழந்தை
மழை என்பதன் பொருள் குன்று	மலை என்பதன் பொருள் குன்று
மழை என்பதன் பொருள் பொருப்பு	மலை என்பதன் பொருள் பொருப்பு
மழை என்பதன் பொருள் வெற்பு	மலை என்பதன் பொருள் வெற்பு
மழை என்பதன் பொருள் சிகரம்	மலை என்பதன் பொருள் சிகரம்
மலை என்பதன் பொருள் மழைநீர்	மழை என்பதன் பொருள் மழைநீர்
மலை என்பதன் பொருள் குளிர்ச்சி	மழை என்பதன் பொருள் குளிர்ச்சி
மலை என்பதன் பொருள் மேகம்	மழை என்பதன் பொருள் மேகம்
மழைத்தல் என்பதன் பொருள் வியத்தல்	மலைத்தல் என்பதன் பொருள் வியத்தல்
மழைத்தல் என்பதன் பொருள் தடுமாறுதல்	மலைத்தல் என்பதன் பொருள் தடுமாறுதல்
மலைத்தல் என்பதன் பொருள் மழை பெய்திருத்தல்	மழைத்தல் என்பதன் பொருள் மழை பெய்திருத்தல்
மலைத்தல் என்பதன் பொருள் குளிர்ந்திருத்தல்	மழைத்தல் என்பதன் பொருள் குளிர்ந்திருத்தல்
மாளை என்பதன் பொருள் அந்திப்பொழுது	மாலை என்பதன் பொருள் அந்திப்பொழுது
மாழை என்பதன் பொருள் பூமாலை	மாலை என்பதன் பொருள் பூமாலை
மாளை என்பதன் பொருள் மயக்கம்	மாழை என்பதன் பொருள் மயக்கம்
மாலை என்பதன் பொருள் மயக்கம்	மாழை என்பதன் பொருள் மயக்கம்
மாளை என்பதன் பொருள் இளமை	மாழை என்பதன் பொருள் இளமை
மாலை என்பதன் பொருள் இளமை	மாழை என்பதன் பொருள் இளமை
மாளை என்பதன் பொருள் அழகு	மாழை என்பதன் பொருள் அழகு
மாலை என்பதன் பொருள் அழகு	மாழை என்பதன் பொருள் அழகு
மாழை என்பதன் பொருள் புளியம்பட்டை	மாளை என்பதன் பொருள் புளியம்பட்டை
மாலை என்பதன் பொருள் புளியம்பட்டை	மாளை என்பதன் பொருள் புளியம்பட்டை
மாள் என்பதன் பொருள் திருமால்	மால் என்பதன் பொருள் திருமால்
மாள் என்பதன் பொருள் மயக்கம்	மால் என்பதன் பொருள் மயக்கம்
மாள் என்பதன் பொருள் அருகன்	மால் என்பதன் பொருள் அருகன்
மாள் என்பதன் பொருள் இந்திரன்	மால் என்பதன் பொருள் இந்திரன்
மாள் என்பதன் பொருள் பெருமை	மால் என்பதன் பொருள் பெருமை
மாள் என்பதன் பொருள் மேகம்	மால் என்பதன் பொருள் மேகம்
மால் என்பதன் பொருள் இறத்தல்	மாள் என்பதன் பொருள் இறத்தல்
மால் என்பதன் பொருள் சாதல் 	மாள் என்பதன் பொருள் சாதல் 
முழை என்பதன் பொருள் உடலிலுள்ள ஓர் உறுப்பு	முலை என்பதன் பொருள் உடலிலுள்ள ஓர் உறுப்பு
முளை என்பதன் பொருள் உடலிலுள்ள ஓர் உறுப்பு	முலை என்பதன் பொருள் உடலிலுள்ள ஓர் உறுப்பு
முளை என்பதன் பொருள் குகை	முழை என்பதன் பொருள் குகை
முலை என்பதன் பொருள் குகை	முழை என்பதன் பொருள் குகை
முலை என்பதன் பொருள் முளைத்தல்	முளை என்பதன் பொருள் முளைத்தல்
முழை என்பதன் பொருள் முளைத்தல்	முளை என்பதன் பொருள் முளைத்தல்
முலை என்பதன் பொருள் தறி	முளை என்பதன் பொருள் தறி
முழை என்பதன் பொருள் தறி	முளை என்பதன் பொருள் தறி
முலை என்பதன் பொருள் ஆப்பு	முளை என்பதன் பொருள் ஆப்பு
முழை என்பதன் பொருள் ஆப்பு	முளை என்பதன் பொருள் ஆப்பு
முலை என்பதன் பொருள் அங்குசம் 	முளை என்பதன் பொருள் அங்குசம் 
முழை என்பதன் பொருள் அங்குசம் 	முளை என்பதன் பொருள் அங்குசம் 
முலை என்பதன் பொருள் இளமை	முளை என்பதன் பொருள் இளமை
முழை என்பதன் பொருள் இளமை	முளை என்பதன் பொருள் இளமை
முலை என்பதன் பொருள் தண்டு	முளை என்பதன் பொருள் தண்டு
முழை என்பதன் பொருள் தண்டு	முளை என்பதன் பொருள் தண்டு
முலை என்பதன் பொருள் மூங்கில்	முளை என்பதன் பொருள் மூங்கில்
முழை என்பதன் பொருள் மூங்கில்	முளை என்பதன் பொருள் மூங்கில்
முளி என்பதன் பொருள் விழித்தல்	முழி என்பதன் பொருள் விழித்தல்
முழி என்பதன் பொருள் மரக்கணு	முளி என்பதன் பொருள் மரக்கணு
முழி என்பதன் பொருள் விரல்முளி	முளி என்பதன் பொருள் விரல்முளி
முழி என்பதன் பொருள் வாட்டம்	முளி என்பதன் பொருள் வாட்டம்
மூழி என்பதன் பொருள் மூலிகை	மூலி என்பதன் பொருள் மூலிகை
மூழி என்பதன் பொருள் மரம்	மூலி என்பதன் பொருள் மரம்
மூழி என்பதன் பொருள் வேருள்ளது	மூலி என்பதன் பொருள் வேருள்ளது
மூலி என்பதன் பொருள் அகப்பை	மூழி என்பதன் பொருள் அகப்பை
மூலி என்பதன் பொருள் சோறு	மூழி என்பதன் பொருள் சோறு
மூலி என்பதன் பொருள் நீர்நிலை	மூழி என்பதன் பொருள் நீர்நிலை
மூலி என்பதன் பொருள் கோணம்	மூழி என்பதன் பொருள் கோணம்
மூளை என்பதன் பொருள் இரு கோடுகள் சந்திக்கும் இடம்	மூலை என்பதன் பொருள் இரு கோடுகள் சந்திக்கும் இடம்
மூலை என்பதன் பொருள் மண்டைக்குள் இருக்கும் ஓர் உறுப்பு	மூளை என்பதன் பொருள் மண்டைக்குள் இருக்கும் ஓர் உறுப்பு
மெள்ள என்பதன் பொருள் மென்று தின்பது	மெல்ல என்பதன் பொருள் மென்று தின்பது
மெல்ல என்பதன் பொருள் மெதுவாக	மெள்ள என்பதன் பொருள் மெதுவாக
மாழி என்பதன் பொருள் மொளலி கிரீடம்	மாலி என்பதன் பொருள் மொளலி கிரீடம்
மாளி என்பதன் பொருள் மொளலி கிரீடம்	மாலி என்பதன் பொருள் மொளலி கிரீடம்
மாளி என்பதன் பொருள் மேழி	மாழி என்பதன் பொருள் மேழி
மாலி என்பதன் பொருள் மேழி	மாழி என்பதன் பொருள் மேழி
மாளி என்பதன் பொருள் கலப்பை	மாழி என்பதன் பொருள் கலப்பை
மாலி என்பதன் பொருள் கலப்பை	மாழி என்பதன் பொருள் கலப்பை
மாலி என்பதன் பொருள் துணிமூட்டை	மாளி என்பதன் பொருள் துணிமூட்டை
மாழி என்பதன் பொருள் துணிமூட்டை	மாளி என்பதன் பொருள் துணிமூட்டை
வளம் என்பதன் பொருள் சுற்றுதல்	வலம் என்பதன் பொருள் சுற்றுதல்
வளம் என்பதன் பொருள் வலப்பக்கம்	வலம் என்பதன் பொருள் வலப்பக்கம்
வளம் என்பதன் பொருள் வெற்றி	வலம் என்பதன் பொருள் வெற்றி
வலம் என்பதன் பொருள் வளமை	வளம் என்பதன் பொருள் வளமை
வலம் என்பதன் பொருள் அழகு	வளம் என்பதன் பொருள் அழகு
வளவன் என்பதன் பொருள் திருமால்	வலவன் என்பதன் பொருள் திருமால்
வலவன் என்பதன் பொருள் சோழன்	வளவன் என்பதன் பொருள் சோழன்
வலவன் என்பதன் பொருள் வேளாளன்	வளவன் என்பதன் பொருள் வேளாளன்
வளன் ஓர் அரசன்	வலன் ஓர் அரசன்
வளன் என்பதன் பொருள் வெற்றி	வலன் என்பதன் பொருள் வெற்றி
வளன் என்பதன் பொருள் வல்லவன்	வலன் என்பதன் பொருள் வல்லவன்
வலன் என்பதன் பொருள் செழுமை	வளன் என்பதன் பொருள் செழுமை
வலன் என்பதன் பொருள் வளப்பன்	வளன் என்பதன் பொருள் வளப்பன்
வளப்பம் என்பதன் பொருள் வழக்கம்	வழப்பம் என்பதன் பொருள் வழக்கம்
வளப்பம் என்பதன் பொருள் இயல்பு	வழப்பம் என்பதன் பொருள் இயல்பு
வழப்பம் என்பதன் பொருள் வளமை	வளப்பம் என்பதன் பொருள் வளமை
வழப்பம் என்பதன் பொருள் செழிப்பு	வளப்பம் என்பதன் பொருள் செழிப்பு
வளி என்பதன் பொருள் நோய்	வலி என்பதன் பொருள் நோய்
வழி என்பதன் பொருள் நோய்	வலி என்பதன் பொருள் நோய்
வளி என்பதன் பொருள் வலிமை	வலி என்பதன் பொருள் வலிமை
வழி என்பதன் பொருள் வலிமை	வலி என்பதன் பொருள் வலிமை
வளி என்பதன் பொருள் துன்பம்	வலி என்பதன் பொருள் துன்பம்
வழி என்பதன் பொருள் துன்பம்	வலி என்பதன் பொருள் துன்பம்
வலி என்பதன் பொருள் நெறி	வழி என்பதன் பொருள் நெறி
வளி என்பதன் பொருள் நெறி	வழி என்பதன் பொருள் நெறி
வலி என்பதன் பொருள் பாதை	வழி என்பதன் பொருள் பாதை
வளி என்பதன் பொருள் பாதை	வழி என்பதன் பொருள் பாதை
வலி என்பதன் பொருள் தடம்	வழி என்பதன் பொருள் தடம்
வளி என்பதன் பொருள் தடம்	வழி என்பதன் பொருள் தடம்
வலி என்பதன் பொருள் உபாயம்	வழி என்பதன் பொருள் உபாயம்
வளி என்பதன் பொருள் உபாயம்	வழி என்பதன் பொருள் உபாயம்
வலி என்பதன் பொருள் காற்று	வளி என்பதன் பொருள் காற்று
வழி என்பதன் பொருள் காற்று	வளி என்பதன் பொருள் காற்று
வழை என்பதன் பொருள் மீன் முதலியன பிடிக்கும் ஒரு கருவி	வலை என்பதன் பொருள் மீன் முதலியன பிடிக்கும் ஒரு கருவி
வளை என்பதன் பொருள் மீன் முதலியன பிடிக்கும் ஒரு கருவி	வலை என்பதன் பொருள் மீன் முதலியன பிடிக்கும் ஒரு கருவி
வளை என்பதன் பொருள் சுரபுன்னை	வழை என்பதன் பொருள் சுரபுன்னை
வலை என்பதன் பொருள் சுரபுன்னை	வழை என்பதன் பொருள் சுரபுன்னை
வளை என்பதன் பொருள் புதுமை	வழை என்பதன் பொருள் புதுமை
வலை என்பதன் பொருள் புதுமை	வழை என்பதன் பொருள் புதுமை
வளை என்பதன் பொருள் இளமை	வழை என்பதன் பொருள் இளமை
வலை என்பதன் பொருள் இளமை	வழை என்பதன் பொருள் இளமை
வலை என்பதன் பொருள் கை வளையல்	வளை என்பதன் பொருள் கை வளையல்
வழை என்பதன் பொருள் கை வளையல்	வளை என்பதன் பொருள் கை வளையல்
வலை என்பதன் பொருள் எலி வளை	வளை என்பதன் பொருள் எலி வளை
வழை என்பதன் பொருள் எலி வளை	வளை என்பதன் பொருள் எலி வளை
வள் என்பதன் பொருள் வலிமை	வல் என்பதன் பொருள் வலிமை
வள் என்பதன் பொருள் விரைவு	வல் என்பதன் பொருள் விரைவு
வள் என்பதன் பொருள் திறமை	வல் என்பதன் பொருள் திறமை
வல் ஒரு ஒலிக்குறிப்புச் சொல்	வள் ஒரு ஒலிக்குறிப்புச் சொல்
வள்ளம் என்பதன் பொருள் வாழை	வல்லம் என்பதன் பொருள் வாழை
வள்ளம் ஓர் ஊர்	வல்லம் ஓர் ஊர்
வல்லம் என்பதன் பொருள் மரக்கலம்	வள்ளம் என்பதன் பொருள் மரக்கலம்
வல்லம் என்பதன் பொருள் படகு	வள்ளம் என்பதன் பொருள் படகு
வல்லம் என்பதன் பொருள் அளவு	வள்ளம் என்பதன் பொருள் அளவு
வல்லம் என்பதன் பொருள் தொன்னை	வள்ளம் என்பதன் பொருள் தொன்னை
வள்ளி என்பதன் பொருள் பூமி	வல்லி என்பதன் பொருள் பூமி
வள்ளி என்பதன் பொருள் பெண்	வல்லி என்பதன் பொருள் பெண்
வள்ளி என்பதன் பொருள் பிரிதல்	வல்லி என்பதன் பொருள் பிரிதல்
வள்ளி என்பதன் பொருள் படர் கொடி	வல்லி என்பதன் பொருள் படர் கொடி
வல்லி என்பதன் பொருள் வள்ளியம்மை	வள்ளி என்பதன் பொருள் வள்ளியம்மை
வல்லி என்பதன் பொருள் ஆபரணம்	வள்ளி என்பதன் பொருள் ஆபரணம்
வல்லி என்பதன் பொருள் சந்திரன்	வள்ளி என்பதன் பொருள் சந்திரன்
வழு என்பதன் பொருள் வலிமை	வலு என்பதன் பொருள் வலிமை
வளு என்பதன் பொருள் வலிமை	வலு என்பதன் பொருள் வலிமை
வழு என்பதன் பொருள் பலம்	வலு என்பதன் பொருள் பலம்
வளு என்பதன் பொருள் பலம்	வலு என்பதன் பொருள் பலம்
வழு என்பதன் பொருள் பற்று	வலு என்பதன் பொருள் பற்று
வளு என்பதன் பொருள் பற்று	வலு என்பதன் பொருள் பற்று
வலு என்பதன் பொருள் குற்றம்	வழு என்பதன் பொருள் குற்றம்
வளு என்பதன் பொருள் குற்றம்	வழு என்பதன் பொருள் குற்றம்
வலு என்பதன் பொருள் தவறு	வழு என்பதன் பொருள் தவறு
வளு என்பதன் பொருள் தவறு	வழு என்பதன் பொருள் தவறு
வலு என்பதன் பொருள் பழிப்புரை	வழு என்பதன் பொருள் பழிப்புரை
வளு என்பதன் பொருள் பழிப்புரை	வழு என்பதன் பொருள் பழிப்புரை
வலு என்பதன் பொருள் கேடு	வழு என்பதன் பொருள் கேடு
வளு என்பதன் பொருள் கேடு	வழு என்பதன் பொருள் கேடு
வழு என்பதன் பொருள் இளமை	வளு என்பதன் பொருள் இளமை
வலு என்பதன் பொருள் இளமை	வளு என்பதன் பொருள் இளமை
வழு என்பதன் பொருள் இளைய	வளு என்பதன் பொருள் இளைய
வலு என்பதன் பொருள் இளைய	வளு என்பதன் பொருள் இளைய
வாளி என்பதன் பொருள் கிஷ்கிந்தை அரசன் 	வாலி என்பதன் பொருள் கிஷ்கிந்தை அரசன் 
வாழி என்பதன் பொருள் கிஷ்கிந்தை அரசன் 	வாலி என்பதன் பொருள் கிஷ்கிந்தை அரசன் 
வாளி என்பதன் பொருள் வாழ்க 	வாழி என்பதன் பொருள் வாழ்க 
வாலி என்பதன் பொருள் வாழ்க 	வாழி என்பதன் பொருள் வாழ்க 
வாலி என்பதன் பொருள் அன்பு	வாளி என்பதன் பொருள் அன்பு
வாழி என்பதன் பொருள் அன்பு	வாளி என்பதன் பொருள் அன்பு
வாலி என்பதன் பொருள் வட்ட வாள்	வாளி என்பதன் பொருள் வட்ட வாள்
வாழி என்பதன் பொருள் வட்ட வாள்	வாளி என்பதன் பொருள் வட்ட வாள்
வாலி என்பதன் பொருள் வீரன்	வாளி என்பதன் பொருள் வீரன்
வாழி என்பதன் பொருள் வீரன்	வாளி என்பதன் பொருள் வீரன்
வாலி என்பதன் பொருள் ஒரு காதணி	வாளி என்பதன் பொருள் ஒரு காதணி
வாழி என்பதன் பொருள் ஒரு காதணி	வாளி என்பதன் பொருள் ஒரு காதணி
வாழை என்பதன் பொருள் இளம்பெண்	வாலை என்பதன் பொருள் இளம்பெண்
வாளை என்பதன் பொருள் இளம்பெண்	வாலை என்பதன் பொருள் இளம்பெண்
வாழை என்பதன் பொருள் திராவகம் வடிக்கும் பாத்திரம்	வாலை என்பதன் பொருள் திராவகம் வடிக்கும் பாத்திரம்
வாளை என்பதன் பொருள் திராவகம் வடிக்கும் பாத்திரம்	வாலை என்பதன் பொருள் திராவகம் வடிக்கும் பாத்திரம்
வாழை என்பதன் பொருள் ஒரு சக்தி	வாலை என்பதன் பொருள் ஒரு சக்தி
வாளை என்பதன் பொருள் ஒரு சக்தி	வாலை என்பதன் பொருள் ஒரு சக்தி
வாளை என்பதன் பொருள் வாழைமரம்	வாழை என்பதன் பொருள் வாழைமரம்
வாலை என்பதன் பொருள் வாழைமரம்	வாழை என்பதன் பொருள் வாழைமரம்
வாலை என்பதன் பொருள் வாளை மீன்	வாளை என்பதன் பொருள் வாளை மீன்
வாழை என்பதன் பொருள் வாளை மீன்	வாளை என்பதன் பொருள் வாளை மீன்
வாழ் என்பதன் பொருள் விலங்குகளின் ஓர் உறுப்பு	வால் என்பதன் பொருள் விலங்குகளின் ஓர் உறுப்பு
வாள் என்பதன் பொருள் விலங்குகளின் ஓர் உறுப்பு	வால் என்பதன் பொருள் விலங்குகளின் ஓர் உறுப்பு
வால் என்பதன் பொருள் வாழ்வாயாக	வாழ் என்பதன் பொருள் வாழ்வாயாக
வாள் என்பதன் பொருள் வாழ்வாயாக	வாழ் என்பதன் பொருள் வாழ்வாயாக
வால் என்பதன் பொருள் போர்வாள்	வாள் என்பதன் பொருள் போர்வாள்
வாழ் என்பதன் பொருள் போர்வாள்	வாள் என்பதன் பொருள் போர்வாள்
வால் என்பதன் பொருள் நீண்டகத்தி	வாள் என்பதன் பொருள் நீண்டகத்தி
வாழ் என்பதன் பொருள் நீண்டகத்தி	வாள் என்பதன் பொருள் நீண்டகத்தி
விழா என்பதன் பொருள் விலா எலும்பு	விலா என்பதன் பொருள் விலா எலும்பு
விளா என்பதன் பொருள் விலா எலும்பு	விலா என்பதன் பொருள் விலா எலும்பு
விளா என்பதன் பொருள் திருவிழா	விழா என்பதன் பொருள் திருவிழா
விலா என்பதன் பொருள் திருவிழா	விழா என்பதன் பொருள் திருவிழா
விளா என்பதன் பொருள் கொண்டாட்டம்	விழா என்பதன் பொருள் கொண்டாட்டம்
விலா என்பதன் பொருள் கொண்டாட்டம்	விழா என்பதன் பொருள் கொண்டாட்டம்
விலா என்பதன் பொருள் இளமை	விளா என்பதன் பொருள் இளமை
விழா என்பதன் பொருள் இளமை	விளா என்பதன் பொருள் இளமை
விலா என்பதன் பொருள் வெண்மை	விளா என்பதன் பொருள் வெண்மை
விழா என்பதன் பொருள் வெண்மை	விளா என்பதன் பொருள் வெண்மை
விலா என்பதன் பொருள் நிணம்	விளா என்பதன் பொருள் நிணம்
விழா என்பதன் பொருள் நிணம்	விளா என்பதன் பொருள் நிணம்
விளி என்பதன் பொருள் கண்	விழி என்பதன் பொருள் கண்
விளி என்பதன் பொருள் கருவிழி	விழி என்பதன் பொருள் கருவிழி
விழி என்பதன் பொருள் கூப்பிடு	விளி என்பதன் பொருள் கூப்பிடு
விழி என்பதன் பொருள் அழை	விளி என்பதன் பொருள் அழை
விழி என்பதன் பொருள் ஏழிசையில் ஒன்று	விளி என்பதன் பொருள் ஏழிசையில் ஒன்று
விழை என்பதன் பொருள் மதிப்பு	விலை என்பதன் பொருள் மதிப்பு
விளை என்பதன் பொருள் மதிப்பு	விலை என்பதன் பொருள் மதிப்பு
விழை என்பதன் பொருள் விலைக்கு விற்றல்	விலை என்பதன் பொருள் விலைக்கு விற்றல்
விளை என்பதன் பொருள் விலைக்கு விற்றல்	விலை என்பதன் பொருள் விலைக்கு விற்றல்
விளை என்பதன் பொருள் விரும்பு	விழை என்பதன் பொருள் விரும்பு
விலை என்பதன் பொருள் விரும்பு	விழை என்பதன் பொருள் விரும்பு
விளை என்பதன் பொருள் ஆசைப்படு	விழை என்பதன் பொருள் ஆசைப்படு
விலை என்பதன் பொருள் ஆசைப்படு	விழை என்பதன் பொருள் ஆசைப்படு
விலை ஒரு மீன்வகை	விளை ஒரு மீன்வகை
விழை ஒரு மீன்வகை	விளை ஒரு மீன்வகை
விலை என்பதன் பொருள் விளைச்சல்	விளை என்பதன் பொருள் விளைச்சல்
விழை என்பதன் பொருள் விளைச்சல்	விளை என்பதன் பொருள் விளைச்சல்
விளக்கு என்பதன் பொருள் விலக்கி விடு	விலக்கு என்பதன் பொருள் விலக்கி விடு
விளக்கு என்பதன் பொருள் தவிர்	விலக்கு என்பதன் பொருள் தவிர்
விலக்கு என்பதன் பொருள் விளக்கமாகச் சொல்	விளக்கு என்பதன் பொருள் விளக்கமாகச் சொல்
விலக்கு என்பதன் பொருள் தீபம்	விளக்கு என்பதன் பொருள் தீபம்
விளங்கு என்பதன் பொருள் பூட்டு	விலங்கு என்பதன் பொருள் பூட்டு
விளங்கு என்பதன் பொருள் கை	விலங்கு என்பதன் பொருள் கை
விளங்கு என்பதன் பொருள் கைகளைப் பிணிக்கும் கருவி	விலங்கு என்பதன் பொருள் கைகளைப் பிணிக்கும் கருவி
விளங்கு என்பதன் பொருள் மிருகம்	விலங்கு என்பதன் பொருள் மிருகம்
விலங்கு என்பதன் பொருள் திகழ்தல்	விளங்கு என்பதன் பொருள் திகழ்தல்
விலங்கு என்பதன் பொருள் சிற்றரத்தை 	விளங்கு என்பதன் பொருள் சிற்றரத்தை 
வெள்ளம் என்பதன் பொருள் சக்கரைக்கட்டி	வெல்லம் என்பதன் பொருள் சக்கரைக்கட்டி
வெள்ளம் என்பதன் பொருள் கருப்பட்டி	வெல்லம் என்பதன் பொருள் கருப்பட்டி
வெல்லம் என்பதன் பொருள் மிதமிஞ்சிய நீர்பெருக்கு	வெள்ளம் என்பதன் பொருள் மிதமிஞ்சிய நீர்பெருக்கு
வேழம் என்பதன் பொருள் வேலமரம்	வேலம் என்பதன் பொருள் வேலமரம்
வேழம் என்பதன் பொருள் தோட்டம்	வேலம் என்பதன் பொருள் தோட்டம்
வேலம் என்பதன் பொருள் யானை	வேழம் என்பதன் பொருள் யானை
வேலம் என்பதன் பொருள் கரும்பு	வேழம் என்பதன் பொருள் கரும்பு
வேலம் என்பதன் பொருள் மூங்கில்	வேழம் என்பதன் பொருள் மூங்கில்
வேள் என்பதன் பொருள் வேலாயுதம்	வேல் என்பதன் பொருள் வேலாயுதம்
வேல் என்பதன் பொருள் வேளிர் குலத்தவன்	வேள் என்பதன் பொருள் வேளிர் குலத்தவன்
வேல் என்பதன் பொருள் மன்மதன்	வேள் என்பதன் பொருள் மன்மதன்
வேல் என்பதன் பொருள் ஆசை	வேள் என்பதன் பொருள் ஆசை
வேளை என்பதன் பொருள் பணி	வேலை என்பதன் பொருள் பணி
வேளை என்பதன் பொருள் கடல்	வேலை என்பதன் பொருள் கடல்
வேலை என்பதன் பொருள் பொழுது	வேளை என்பதன் பொருள் பொழுது
வேலை என்பதன் பொருள் நேரம்	வேளை என்பதன் பொருள் நேரம்
வேலை என்பதன் பொருள் ஒருவகைக் கீரை	வேளை என்பதன் பொருள் ஒருவகைக் கீரை
அற என்பதன் பொருள் பாம்பு	அர என்பதன் பொருள் பாம்பு
அர என்பதன் பொருள் தெளிய	அற என்பதன் பொருள் தெளிய
அர என்பதன் பொருள் முற்றுமாக	அற என்பதன் பொருள் முற்றுமாக
அறவு என்பதன் பொருள் பாம்பு	அரவு என்பதன் பொருள் பாம்பு
அரவு என்பதன் பொருள் அறுதல்	அறவு என்பதன் பொருள் அறுதல்
அரவு என்பதன் பொருள் தொலைதல்	அறவு என்பதன் பொருள் தொலைதல்
அறம் என்பதன் பொருள் ஒரு கருவி	அரம் என்பதன் பொருள் ஒரு கருவி
அரம் என்பதன் பொருள் தர்மம்	அறம் என்பதன் பொருள் தர்மம்
அரம் என்பதன் பொருள் நீதி	அறம் என்பதன் பொருள் நீதி
அரம் என்பதன் பொருள் புண்ணியம்	அறம் என்பதன் பொருள் புண்ணியம்
அரம் என்பதன் பொருள் கடமை	அறம் என்பதன் பொருள் கடமை
அரம் என்பதன் பொருள் அறநூல்	அறம் என்பதன் பொருள் அறநூல்
அரம் என்பதன் பொருள் துறவறம்	அறம் என்பதன் பொருள் துறவறம்
அறி என்பதன் பொருள் திருமால்	அரி என்பதன் பொருள் திருமால்
அறி என்பதன் பொருள் அரிசி	அரி என்பதன் பொருள் அரிசி
அறி என்பதன் பொருள் அழகு	அரி என்பதன் பொருள் அழகு
அறி என்பதன் பொருள் அரிதல்	அரி என்பதன் பொருள் அரிதல்
அறி என்பதன் பொருள் பன்றி	அரி என்பதன் பொருள் பன்றி
அறி என்பதன் பொருள் வண்டு	அரி என்பதன் பொருள் வண்டு
அறி என்பதன் பொருள் கடல்	அரி என்பதன் பொருள் கடல்
அறி என்பதன் பொருள் தகடு	அரி என்பதன் பொருள் தகடு
அறி என்பதன் பொருள் சிவன்	அரி என்பதன் பொருள் சிவன்
அறி என்பதன் பொருள் சிங்கம்.	அரி என்பதன் பொருள் சிங்கம்.
அரி என்பதன் பொருள் அறிந்துகொள்	அறி என்பதன் பொருள் அறிந்துகொள்
அறிய என்பதன் பொருள் கிடைத்தற்கு அரிதான	அரிய என்பதன் பொருள் கிடைத்தற்கு அரிதான
அறிய என்பதன் பொருள் கஷ்டமான	அரிய என்பதன் பொருள் கஷ்டமான
அரிய என்பதன் பொருள் அறிந்து கொள்ள	அறிய என்பதன் பொருள் அறிந்து கொள்ள
அரிய என்பதன் பொருள் தெரிந்து கொள்ள	அறிய என்பதன் பொருள் தெரிந்து கொள்ள
அறன் என்பதன் பொருள் சிவன்	அரன் என்பதன் பொருள் சிவன்
அரன் என்பதன் பொருள் தர்மம்	அறன் என்பதன் பொருள் தர்மம்
அரன் என்பதன் பொருள் அறக்கடவுள்	அறன் என்பதன் பொருள் அறக்கடவுள்
அறிவை என்பதன் பொருள் எட்டு வயதுக்கு மேல் இருபத்து ஐந்து வயதுக்குட்பட்ட பெண்	அரிவை என்பதன் பொருள் எட்டு வயதுக்கு மேல் இருபத்து ஐந்து வயதுக்குட்பட்ட பெண்
அரிவை என்பதன் பொருள் அறிவாய்	அறிவை என்பதன் பொருள் அறிவாய்
அறுகு என்பதன் பொருள் அருகம்புல்	அருகு என்பதன் பொருள் அருகம்புல்
அறுகு என்பதன் பொருள் அண்மை	அருகு என்பதன் பொருள் அண்மை
அருகு என்பதன் பொருள் குறைந்து போதல்	அறுகு என்பதன் பொருள் குறைந்து போதல்
அக்கறை என்பதன் பொருள் அந்தக் கரை	அக்கரை என்பதன் பொருள் அந்தக் கரை
அக்கரை என்பதன் பொருள் ஈடுபாடு	அக்கறை என்பதன் பொருள் ஈடுபாடு
அறை என்பதன் பொருள் பாதி	அரை என்பதன் பொருள் பாதி
அறை என்பதன் பொருள் மேகலை	அரை என்பதன் பொருள் மேகலை
அறை என்பதன் பொருள் வயிறு	அரை என்பதன் பொருள் வயிறு
அறை என்பதன் பொருள் ஒரு மரம்	அரை என்பதன் பொருள் ஒரு மரம்
அரை என்பதன் பொருள் வீட்டின் பகுதி	அறை என்பதன் பொருள் வீட்டின் பகுதி
அரை என்பதன் பொருள் அடி	அறை என்பதன் பொருள் அடி
அரை என்பதன் பொருள் பாத்தி	அறை என்பதன் பொருள் பாத்தி
அரை என்பதன் பொருள் ஒலி	அறை என்பதன் பொருள் ஒலி
அரை என்பதன் பொருள் பாசறை	அறை என்பதன் பொருள் பாசறை
அரை என்பதன் பொருள் சொல்	அறை என்பதன் பொருள் சொல்
அரை என்பதன் பொருள் குகை	அறை என்பதன் பொருள் குகை
அரை என்பதன் பொருள் வஞ்சனை	அறை என்பதன் பொருள் வஞ்சனை
அரை என்பதன் பொருள் மாளிகை	அறை என்பதன் பொருள் மாளிகை
அறைதல் என்பதன் பொருள் தேய்தல்	அரைதல் என்பதன் பொருள் தேய்தல்
அரைதல் என்பதன் பொருள் அடித்தல்	அறைதல் என்பதன் பொருள் அடித்தல்
அரைதல் என்பதன் பொருள் சொல்லுதல்	அறைதல் என்பதன் பொருள் சொல்லுதல்
அப்புறம் என்பதன் பொருள் அந்தப் பக்கம்	அப்புரம் என்பதன் பொருள் அந்தப் பக்கம்
அப்புரம் என்பதன் பொருள் பிறகு	அப்புறம் என்பதன் பொருள் பிறகு
அற்பணம் என்பதன் பொருள் உரித்தாக்குதல்	அர்ப்பணம் என்பதன் பொருள் உரித்தாக்குதல்
அர்ப்பணம் என்பதன் பொருள் காணிக்கை செலுத்துதல்	அற்பணம் என்பதன் பொருள் காணிக்கை செலுத்துதல்
அறு என்பதன் பொருள் உருவமற்றது	அரு என்பதன் பொருள் உருவமற்றது
அரு என்பதன் பொருள் துண்டித்து விடு	அறு என்பதன் பொருள் துண்டித்து விடு
அரு என்பதன் பொருள் அறுத்து விடு	அறு என்பதன் பொருள் அறுத்து விடு
அறுமை என்பதன் பொருள் சிறப்பு	அருமை என்பதன் பொருள் சிறப்பு
அறுமை என்பதன் பொருள் அன்பு	அருமை என்பதன் பொருள் அன்பு
அறுமை என்பதன் பொருள் இன்மை	அருமை என்பதன் பொருள் இன்மை
அறுமை என்பதன் பொருள் சுலபத்தில் கிடைக்காதது	அருமை என்பதன் பொருள் சுலபத்தில் கிடைக்காதது
அருமை என்பதன் பொருள் நிலையின்மை	அறுமை என்பதன் பொருள் நிலையின்மை
அருமை என்பதன் பொருள் ஆறு	அறுமை என்பதன் பொருள் ஆறு
ஆறு என்பதன் பொருள் குடம்	ஆரு என்பதன் பொருள் குடம்
ஆறு என்பதன் பொருள் நண்டு	ஆரு என்பதன் பொருள் நண்டு
ஆரு என்பதன் பொருள் ஒரு எண்	ஆறு என்பதன் பொருள் ஒரு எண்
ஆரு என்பதன் பொருள் வழி	ஆறு என்பதன் பொருள் வழி
ஆரு என்பதன் பொருள் சமயம்	ஆறு என்பதன் பொருள் சமயம்
ஆரு என்பதன் பொருள் தன்மை	ஆறு என்பதன் பொருள் தன்மை
ஆரு என்பதன் பொருள் நதி	ஆறு என்பதன் பொருள் நதி
ஆரு என்பதன் பொருள் ஒழுக்கம்	ஆறு என்பதன் பொருள் ஒழுக்கம்
ஆரு என்பதன் பொருள் பக்கம்	ஆறு என்பதன் பொருள் பக்கம்
ஆரு என்பதன் பொருள் நிலை	ஆறு என்பதன் பொருள் நிலை
ஆற என்பதன் பொருள் நிறைய	ஆர என்பதன் பொருள் நிறைய
ஆற என்பதன் பொருள் அனுபவிக்க	ஆர என்பதன் பொருள் அனுபவிக்க
ஆர என்பதன் பொருள் சூடு குறைய	ஆற என்பதன் பொருள் சூடு குறைய
ஆறல் ஒருவகை மீன்	ஆரல் ஒருவகை மீன்
ஆரல் என்பதன் பொருள் சூடு குறைதல்	ஆறல் என்பதன் பொருள் சூடு குறைதல்
இறத்தல் என்பதன் பொருள் யாசித்தல்	இரத்தல் என்பதன் பொருள் யாசித்தல்
இரத்தல் என்பதன் பொருள் இறந்துபோதல்	இறத்தல் என்பதன் பொருள் இறந்துபோதல்
இரத்தல் என்பதன் பொருள் சாதல்	இறத்தல் என்பதன் பொருள் சாதல்
இறகு என்பதன் பொருள் சூரியன்	இரகு என்பதன் பொருள் சூரியன்
இரகு என்பதன் பொருள் சிறகு	இறகு என்பதன் பொருள் சிறகு
இறக்கம் என்பதன் பொருள் கருணை	இரக்கம் என்பதன் பொருள் கருணை
இரக்கம் என்பதன் பொருள் சரிவு	இறக்கம் என்பதன் பொருள் சரிவு
இரக்கம் என்பதன் பொருள் மரணம்	இறக்கம் என்பதன் பொருள் மரணம்
இறங்கு என்பதன் பொருள் கருணைகாட்டு	இரங்கு என்பதன் பொருள் கருணைகாட்டு
இரங்கு என்பதன் பொருள் கீழிறங்கி வா	இறங்கு என்பதன் பொருள் கீழிறங்கி வா
இறவம் என்பதன் பொருள் இரவு	இரவம் என்பதன் பொருள் இரவு
இரவம் என்பதன் பொருள் இறால் மீன்	இறவம் என்பதன் பொருள் இறால் மீன்
இறவி என்பதன் பொருள் சூரியன்	இரவி என்பதன் பொருள் சூரியன்
இறவி என்பதன் பொருள் எருக்கு	இரவி என்பதன் பொருள் எருக்கு
இறவி என்பதன் பொருள் மலை	இரவி என்பதன் பொருள் மலை
இறவி என்பதன் பொருள் வாணிகத்தொழில்	இரவி என்பதன் பொருள் வாணிகத்தொழில்
இரவி என்பதன் பொருள் இறத்தல்	இறவி என்பதன் பொருள் இறத்தல்
இறவு என்பதன் பொருள் இரவு நேரம்	இரவு என்பதன் பொருள் இரவு நேரம்
இறவு என்பதன் பொருள் யாசித்தல்	இரவு என்பதன் பொருள் யாசித்தல்
இரவு என்பதன் பொருள் மிகுதி	இறவு என்பதன் பொருள் மிகுதி
இரவு என்பதன் பொருள் இறால்மீன்	இறவு என்பதன் பொருள் இறால்மீன்
இரவு என்பதன் பொருள் இறுதி	இறவு என்பதன் பொருள் இறுதி
இரவு என்பதன் பொருள் தேன்கூடு	இறவு என்பதன் பொருள் தேன்கூடு
இரவு என்பதன் பொருள் சாவு	இறவு என்பதன் பொருள் சாவு
இரவு என்பதன் பொருள் முடிவு	இறவு என்பதன் பொருள் முடிவு
இரவு என்பதன் பொருள் நீக்கம்	இறவு என்பதன் பொருள் நீக்கம்
இறை என்பதன் பொருள் ஒலி	இரை என்பதன் பொருள் ஒலி
இறை என்பதன் பொருள் உணவு	இரை என்பதன் பொருள் உணவு
இரை என்பதன் பொருள் கடவுள்	இறை என்பதன் பொருள் கடவுள்
இரை என்பதன் பொருள் அணு	இறை என்பதன் பொருள் அணு
இரை என்பதன் பொருள் அரசன்	இறை என்பதன் பொருள் அரசன்
இரை என்பதன் பொருள் ரேகை	இறை என்பதன் பொருள் ரேகை
இரை என்பதன் பொருள் சந்து	இறை என்பதன் பொருள் சந்து
இரை என்பதன் பொருள் கடமை	இறை என்பதன் பொருள் கடமை
இரை என்பதன் பொருள் தலைமை	இறை என்பதன் பொருள் தலைமை
இரை என்பதன் பொருள் விடை	இறை என்பதன் பொருள் விடை
இரை என்பதன் பொருள் உயரம்	இறை என்பதன் பொருள் உயரம்
இரை என்பதன் பொருள் மூலை	இறை என்பதன் பொருள் மூலை
இறு என்பதன் பொருள் இரண்டு	இரு என்பதன் பொருள் இரண்டு
இறு என்பதன் பொருள் பெரிய	இரு என்பதன் பொருள் பெரிய
இறு என்பதன் பொருள் உட்கார்	இரு என்பதன் பொருள் உட்கார்
இறு என்பதன் பொருள் அமர்ந்துகொள்	இரு என்பதன் பொருள் அமர்ந்துகொள்
இரு என்பதன் பொருள் ஒடி	இறு என்பதன் பொருள் ஒடி
இரு என்பதன் பொருள் கெடு	இறு என்பதன் பொருள் கெடு
இரு என்பதன் பொருள் சொல்லு	இறு என்பதன் பொருள் சொல்லு
இறும்பு என்பதன் பொருள் கடிவாளம்	இரும்பு என்பதன் பொருள் கடிவாளம்
இறும்பு என்பதன் பொருள் கிம்புரி	இரும்பு என்பதன் பொருள் கிம்புரி
இறும்பு என்பதன் பொருள் ஆயுதம்	இரும்பு என்பதன் பொருள் ஆயுதம்
இறும்பு என்பதன் பொருள் ஓர் உலோகம்	இரும்பு என்பதன் பொருள் ஓர் உலோகம்
இரும்பு என்பதன் பொருள் வண்டு	இறும்பு என்பதன் பொருள் வண்டு
இரும்பு என்பதன் பொருள் சிறுமலை	இறும்பு என்பதன் பொருள் சிறுமலை
இறுப்பு என்பதன் பொருள் கையிருப்பு	இருப்பு என்பதன் பொருள் கையிருப்பு
இறுப்பு என்பதன் பொருள் இருப்பிடம்	இருப்பு என்பதன் பொருள் இருப்பிடம்
இறுப்பு என்பதன் பொருள் ஆசனம்	இருப்பு என்பதன் பொருள் ஆசனம்
இறுப்பு என்பதன் பொருள் நிலை	இருப்பு என்பதன் பொருள் நிலை
இறுப்பு என்பதன் பொருள் பொருள்	இருப்பு என்பதன் பொருள் பொருள்
இறுப்பு என்பதன் பொருள் முதல்	இருப்பு என்பதன் பொருள் முதல்
இருப்பு என்பதன் பொருள் வடிப்பு	இறுப்பு என்பதன் பொருள் வடிப்பு
இறுத்தல் என்பதன் பொருள் அமர்ந்திருத்தல்	இருத்தல் என்பதன் பொருள் அமர்ந்திருத்தல்
இறுத்தல் என்பதன் பொருள் காத்திருத்தல்	இருத்தல் என்பதன் பொருள் காத்திருத்தல்
இருத்தல் என்பதன் பொருள் வடித்தல்	இறுத்தல் என்பதன் பொருள் வடித்தல்
இருத்தல் என்பதன் பொருள் செலுத்தல்	இறுத்தல் என்பதன் பொருள் செலுத்தல்
இருத்தல் என்பதன் பொருள் எறிதல்	இறுத்தல் என்பதன் பொருள் எறிதல்
இருத்தல் என்பதன் பொருள் கடன் கொடுத்தல்	இறுத்தல் என்பதன் பொருள் கடன் கொடுத்தல்
இருத்தல் என்பதன் பொருள் பதில்கூறல்	இறுத்தல் என்பதன் பொருள் பதில்கூறல்
இருத்தல் என்பதன் பொருள் முடித்தல்	இறுத்தல் என்பதன் பொருள் முடித்தல்
இருத்தல் என்பதன் பொருள் முறித்தல்	இறுத்தல் என்பதன் பொருள் முறித்தல்
இறுக்கு என்பதன் பொருள் மந்திரம்	இருக்கு என்பதன் பொருள் மந்திரம்
இறுக்கு என்பதன் பொருள் ரிக் வேதம்	இருக்கு என்பதன் பொருள் ரிக் வேதம்
இருக்கு என்பதன் பொருள் அழுத்து	இறுக்கு என்பதன் பொருள் அழுத்து
இருக்கு என்பதன் பொருள் இறுக்கிக்கட்டு	இறுக்கு என்பதன் பொருள் இறுக்கிக்கட்டு
இறைத்தல் என்பதன் பொருள் ஒலித்தல்	இரைத்தல் என்பதன் பொருள் ஒலித்தல்
இறைத்தல் என்பதன் பொருள் மூச்சுவாங்குதல்	இரைத்தல் என்பதன் பொருள் மூச்சுவாங்குதல்
இரைத்தல் என்பதன் பொருள் சிதறுதல்	இறைத்தல் என்பதன் பொருள் சிதறுதல்
இரைத்தல் என்பதன் பொருள் மிகு செலவு	இறைத்தல் என்பதன் பொருள் மிகு செலவு
உறவு என்பதன் பொருள் அறிவு	உரவு என்பதன் பொருள் அறிவு
உறவு என்பதன் பொருள் ஒலி	உரவு என்பதன் பொருள் ஒலி
உறவு என்பதன் பொருள் மிகுதி	உரவு என்பதன் பொருள் மிகுதி
உறவு என்பதன் பொருள் வலி	உரவு என்பதன் பொருள் வலி
உறவு என்பதன் பொருள் ஞானம்	உரவு என்பதன் பொருள் ஞானம்
உறவு என்பதன் பொருள் விடம்	உரவு என்பதன் பொருள் விடம்
உரவு என்பதன் பொருள் நட்பு	உறவு என்பதன் பொருள் நட்பு
உரவு என்பதன் பொருள் சுற்றம்	உறவு என்பதன் பொருள் சுற்றம்
உரவு என்பதன் பொருள் எறும்பு	உறவு என்பதன் பொருள் எறும்பு
உறவோர் என்பதன் பொருள் அறிஞர்	உரவோர் என்பதன் பொருள் அறிஞர்
உறவோர் என்பதன் பொருள் முனிவர்	உரவோர் என்பதன் பொருள் முனிவர்
உரவோர் என்பதன் பொருள் சுற்றத்தார்	உறவோர் என்பதன் பொருள் சுற்றத்தார்
உரவோர் என்பதன் பொருள் அடைந்தோர்	உறவோர் என்பதன் பொருள் அடைந்தோர்
உறி என்பதன் பொருள் தோல்	உரி என்பதன் பொருள் தோல்
உறி என்பதன் பொருள் மரப்பட்டை	உரி என்பதன் பொருள் மரப்பட்டை
உறி என்பதன் பொருள் அரைப்படியளவு	உரி என்பதன் பொருள் அரைப்படியளவு
உறி என்பதன் பொருள் உரிச்சொல்	உரி என்பதன் பொருள் உரிச்சொல்
உறி என்பதன் பொருள் கொத்துமல்லி	உரி என்பதன் பொருள் கொத்துமல்லி
உரி என்பதன் பொருள் உறிவெண்ணெய்	உறி என்பதன் பொருள் உறிவெண்ணெய்
உரி என்பதன் பொருள் தூக்கு	உறி என்பதன் பொருள் தூக்கு
உறு என்பதன் பொருள் வடிவம்	உரு என்பதன் பொருள் வடிவம்
உறு என்பதன் பொருள் அழகு	உரு என்பதன் பொருள் அழகு
உறு என்பதன் பொருள் உடல்	உரு என்பதன் பொருள் உடல்
உறு என்பதன் பொருள் மரக்கலம்	உரு என்பதன் பொருள் மரக்கலம்
உறு என்பதன் பொருள் நிறம்	உரு என்பதன் பொருள் நிறம்
உறு என்பதன் பொருள் அச்சம்	உரு என்பதன் பொருள் அச்சம்
உறு என்பதன் பொருள் பெருமை	உரு என்பதன் பொருள் பெருமை
உறு என்பதன் பொருள் மேன்மை	உரு என்பதன் பொருள் மேன்மை
உரு என்பதன் பொருள் மிகுதி	உறு என்பதன் பொருள் மிகுதி
உறுக்குதல் என்பதன் பொருள் இளக்குதல்	உருக்குதல் என்பதன் பொருள் இளக்குதல்
உறுக்குதல் என்பதன் பொருள் மெலியச் செய்தல்	உருக்குதல் என்பதன் பொருள் மெலியச் செய்தல்
உருக்குதல் என்பதன் பொருள் சினத்தல்	உறுக்குதல் என்பதன் பொருள் சினத்தல்
உருக்குதல் என்பதன் பொருள் அதட்டுதல்	உறுக்குதல் என்பதன் பொருள் அதட்டுதல்
உறை என்பதன் பொருள் புகழ்	உரை என்பதன் பொருள் புகழ்
உறை என்பதன் பொருள் விளக்கவுரை	உரை என்பதன் பொருள் விளக்கவுரை
உறை என்பதன் பொருள் நூல்	உரை என்பதன் பொருள் நூல்
உறை என்பதன் பொருள் பொன்மாற்று	உரை என்பதன் பொருள் பொன்மாற்று
உறை என்பதன் பொருள் அறிவுரை	உரை என்பதன் பொருள் அறிவுரை
உறை என்பதன் பொருள் சொல்	உரை என்பதன் பொருள் சொல்
உரை என்பதன் பொருள் இடம்	உறை என்பதன் பொருள் இடம்
உரை என்பதன் பொருள் பண்டம்	உறை என்பதன் பொருள் பண்டம்
உரை என்பதன் பொருள் பொருள்	உறை என்பதன் பொருள் பொருள்
உரை என்பதன் பொருள் மருந்து	உறை என்பதன் பொருள் மருந்து
உரை என்பதன் பொருள் பாலில் இடும் பிரை	உறை என்பதன் பொருள் பாலில் இடும் பிரை
உரை என்பதன் பொருள் துளி	உறை என்பதன் பொருள் துளி
உரை என்பதன் பொருள் மழை	உறை என்பதன் பொருள் மழை
உரை என்பதன் பொருள் ஆடை	உறை என்பதன் பொருள் ஆடை
உரை என்பதன் பொருள் துன்பம்	உறை என்பதன் பொருள் துன்பம்
உரை என்பதன் பொருள் பாம்பின் விஷப்பை	உறை என்பதன் பொருள் பாம்பின் விஷப்பை
உறைப்பு என்பதன் பொருள் தங்குதல்	உரைப்பு என்பதன் பொருள் தங்குதல்
உறைப்பு என்பதன் பொருள் தோய்தல்	உரைப்பு என்பதன் பொருள் தோய்தல்
உரைப்பு என்பதன் பொருள் காரம்	உறைப்பு என்பதன் பொருள் காரம்
உரைப்பு என்பதன் பொருள் கொடுமை	உறைப்பு என்பதன் பொருள் கொடுமை
உறையல் என்பதன் பொருள் சொல்லல்	உரையல் என்பதன் பொருள் சொல்லல்
உரையல் என்பதன் பொருள் மாறுபாடு	உறையல் என்பதன் பொருள் மாறுபாடு
உரையல் என்பதன் பொருள் பிணக்கு	உறையல் என்பதன் பொருள் பிணக்கு
உறிய என்பதன் பொருள் உரிமையான	உரிய என்பதன் பொருள் உரிமையான
உரிய என்பதன் பொருள் உறிஞ்ச	உறிய என்பதன் பொருள் உறிஞ்ச
ஊறல் என்பதன் பொருள் ஊர்தல்	ஊரல் என்பதன் பொருள் ஊர்தல்
ஊறல் என்பதன் பொருள் கிளிஞ்சல்	ஊரல் என்பதன் பொருள் கிளிஞ்சல்
ஊறல் என்பதன் பொருள் ஒருவகைப் பறவை	ஊரல் என்பதன் பொருள் ஒருவகைப் பறவை
ஊரல் என்பதன் பொருள் தினவு	ஊறல் என்பதன் பொருள் தினவு
ஊரல் என்பதன் பொருள் ஊற்று	ஊறல் என்பதன் பொருள் ஊற்று
ஊரல் என்பதன் பொருள் சாறு	ஊறல் என்பதன் பொருள் சாறு
ஊரல் என்பதன் பொருள் வருவாய்	ஊறல் என்பதன் பொருள் வருவாய்
ஊரல் என்பதன் பொருள் ஊறுதல்	ஊறல் என்பதன் பொருள் ஊறுதல்
ஊரல் என்பதன் பொருள் களிப்பு	ஊறல் என்பதன் பொருள் களிப்பு
ஊறு என்பதன் பொருள் அச்சம்	ஊரு என்பதன் பொருள் அச்சம்
ஊறு என்பதன் பொருள் தொடை	ஊரு என்பதன் பொருள் தொடை
ஊரு என்பதன் பொருள் இடையூறு	ஊறு என்பதன் பொருள் இடையூறு
ஊரு என்பதன் பொருள் துன்பம்	ஊறு என்பதன் பொருள் துன்பம்
ஊரு என்பதன் பொருள் காயம் உறுதல்	ஊறு என்பதன் பொருள் காயம் உறுதல்
ஊரு என்பதன் பொருள் தீண்டல்	ஊறு என்பதன் பொருள் தீண்டல்
ஊரு என்பதன் பொருள் குற்றம்	ஊறு என்பதன் பொருள் குற்றம்
ஊரு என்பதன் பொருள் புண்	ஊறு என்பதன் பொருள் புண்
ஊரு என்பதன் பொருள் கொலை	ஊறு என்பதன் பொருள் கொலை
எறி என்பதன் பொருள் தீ	எரி என்பதன் பொருள் தீ
எறி என்பதன் பொருள் கார்த்திகை	எரி என்பதன் பொருள் கார்த்திகை
எறி என்பதன் பொருள் பிரபை	எரி என்பதன் பொருள் பிரபை
எறி என்பதன் பொருள் இடபராசி	எரி என்பதன் பொருள் இடபராசி
எறி என்பதன் பொருள் நெருப்பு	எரி என்பதன் பொருள் நெருப்பு
எறி என்பதன் பொருள் நரகம்	எரி என்பதன் பொருள் நரகம்
எறி என்பதன் பொருள் வெம்மை	எரி என்பதன் பொருள் வெம்மை
எறி என்பதன் பொருள் கந்தகம்	எரி என்பதன் பொருள் கந்தகம்
எரி என்பதன் பொருள் விடுதல்	எறி என்பதன் பொருள் விடுதல்
எரி என்பதன் பொருள் எறிதல்	எறி என்பதன் பொருள் எறிதல்
எரி என்பதன் பொருள் குறிப்பாகக் கூறுதல்	எறி என்பதன் பொருள் குறிப்பாகக் கூறுதல்
ஏற என்பதன் பொருள் ஓர் உவம உருபு	ஏர என்பதன் பொருள் ஓர் உவம உருபு
ஏர என்பதன் பொருள் மிகுதி	ஏற என்பதன் பொருள் மிகுதி
ஏர என்பதன் பொருள் உயர ஏறுதல்	ஏற என்பதன் பொருள் உயர ஏறுதல்
ஏறி என்பதன் பொருள் நீர்நிலை	ஏரி என்பதன் பொருள் நீர்நிலை
ஏறி என்பதன் பொருள் குளம்	ஏரி என்பதன் பொருள் குளம்
ஏரி என்பதன் பொருள் உயர்ந்த	ஏறி என்பதன் பொருள் உயர்ந்த
ஏரி என்பதன் பொருள் மேலே ஏறி	ஏறி என்பதன் பொருள் மேலே ஏறி
ஒறு என்பதன் பொருள் ஒன்று	ஒரு என்பதன் பொருள் ஒன்று
ஒறு என்பதன் பொருள் ஒப்பற்ற	ஒரு என்பதன் பொருள் ஒப்பற்ற
ஒறு என்பதன் பொருள் ஆடு	ஒரு என்பதன் பொருள் ஆடு
ஒரு என்பதன் பொருள் தண்டி	ஒறு என்பதன் பொருள் தண்டி
ஒரு என்பதன் பொருள் அழி	ஒறு என்பதன் பொருள் அழி
ஒரு என்பதன் பொருள் இகழ்	ஒறு என்பதன் பொருள் இகழ்
ஒறுத்தல் என்பதன் பொருள் ஆண் விலங்குகளின் பொதுப்பெயர்	ஒருத்தல் என்பதன் பொருள் ஆண் விலங்குகளின் பொதுப்பெயர்
ஒருத்தல் என்பதன் பொருள் தண்டித்தல்	ஒறுத்தல் என்பதன் பொருள் தண்டித்தல்
ஒருத்தல் என்பதன் பொருள் துன்புறுத்தல்	ஒறுத்தல் என்பதன் பொருள் துன்புறுத்தல்
ஒருத்தல் என்பதன் பொருள் வருத்துதல்	ஒறுத்தல் என்பதன் பொருள் வருத்துதல்
ஒருத்தல் என்பதன் பொருள் வெறுத்தல்	ஒறுத்தல் என்பதன் பொருள் வெறுத்தல்
ஒருத்தல் என்பதன் பொருள் கடிதல்	ஒறுத்தல் என்பதன் பொருள் கடிதல்
ஒருத்தல் என்பதன் பொருள் இகழ்தல்	ஒறுத்தல் என்பதன் பொருள் இகழ்தல்
ஒருத்தல் என்பதன் பொருள் குறைத்தல்	ஒறுத்தல் என்பதன் பொருள் குறைத்தல்
ஒறுவு என்பதன் பொருள் நீங்கு	ஒருவு என்பதன் பொருள் நீங்கு
ஒருவு என்பதன் பொருள் வருத்தம்	ஒறுவு என்பதன் பொருள் வருத்தம்
ஒருவு என்பதன் பொருள் துன்பம்	ஒறுவு என்பதன் பொருள் துன்பம்
கறடு என்பதன் பொருள் மரக்கணு	கரடு என்பதன் பொருள் மரக்கணு
கறடு என்பதன் பொருள் மணிக்கட்டு	கரடு என்பதன் பொருள் மணிக்கட்டு
கறடு என்பதன் பொருள் முருடு	கரடு என்பதன் பொருள் முருடு
கறடு என்பதன் பொருள் வளர்ச்சியற்றது	கரடு என்பதன் பொருள் வளர்ச்சியற்றது
கரடு என்பதன் பொருள் தரமற்ற முத்து	கறடு என்பதன் பொருள் தரமற்ற முத்து
கறம் என்பதன் பொருள் கிரணம்	கரம் என்பதன் பொருள் கிரணம்
கறம் என்பதன் பொருள் விஷம்	கரம் என்பதன் பொருள் விஷம்
கறம் என்பதன் பொருள் செயல்	கரம் என்பதன் பொருள் செயல்
கறம் என்பதன் பொருள் கை	கரம் என்பதன் பொருள் கை
கறம் என்பதன் பொருள் கழுதை	கரம் என்பதன் பொருள் கழுதை
கரம் என்பதன் பொருள் கொடுமை	கறம் என்பதன் பொருள் கொடுமை
கரம் என்பதன் பொருள் வன்செய்கை	கறம் என்பதன் பொருள் வன்செய்கை
கறவு என்பதன் பொருள் பொய்	கரவு என்பதன் பொருள் பொய்
கறவு என்பதன் பொருள் வஞ்சனை	கரவு என்பதன் பொருள் வஞ்சனை
கறவு என்பதன் பொருள் மறைவு	கரவு என்பதன் பொருள் மறைவு
கரவு என்பதன் பொருள் கப்பம்	கறவு என்பதன் பொருள் கப்பம்
கறவை என்பதன் பொருள் கம்மாளர் கருவி	கரவை என்பதன் பொருள் கம்மாளர் கருவி
கரவை என்பதன் பொருள் பாற்பசு	கறவை என்பதன் பொருள் பாற்பசு
கறி என்பதன் பொருள் அடுப்புக்கரி	கரி என்பதன் பொருள் அடுப்புக்கரி
கறி என்பதன் பொருள் நிலக்கரி	கரி என்பதன் பொருள் நிலக்கரி
கறி என்பதன் பொருள் யானை	கரி என்பதன் பொருள் யானை
கறி என்பதன் பொருள் சாட்சி	கரி என்பதன் பொருள் சாட்சி
கறி என்பதன் பொருள் பெண் கழுதை	கரி என்பதன் பொருள் பெண் கழுதை
கறி என்பதன் பொருள் விஷம்	கரி என்பதன் பொருள் விஷம்
கறி என்பதன் பொருள் கருமை	கரி என்பதன் பொருள் கருமை
கரி என்பதன் பொருள் இறைச்சி	கறி என்பதன் பொருள் இறைச்சி
கரி என்பதன் பொருள் மிளகு	கறி என்பதன் பொருள் மிளகு
கறத்தல் என்பதன் பொருள் மறைத்தல்	கரத்தல் என்பதன் பொருள் மறைத்தல்
கரத்தல் என்பதன் பொருள் கவர்தல்	கறத்தல் என்பதன் பொருள் கவர்தல்
கரத்தல் என்பதன் பொருள் பால் கறத்தல்	கறத்தல் என்பதன் பொருள் பால் கறத்தல்
கறுத்து என்பதன் பொருள் எண்ணம்	கருத்து என்பதன் பொருள் எண்ணம்
கருத்து என்பதன் பொருள் கருநிறங்கொண்டு	கறுத்து என்பதன் பொருள் கருநிறங்கொண்டு
கறு என்பதன் பொருள் சினை	கரு என்பதன் பொருள் சினை
கறு என்பதன் பொருள் பிறவி	கரு என்பதன் பொருள் பிறவி
கறு என்பதன் பொருள் முட்டை	கரு என்பதன் பொருள் முட்டை
கறு என்பதன் பொருள் நடு	கரு என்பதன் பொருள் நடு
கறு என்பதன் பொருள் கருநிறம்	கரு என்பதன் பொருள் கருநிறம்
கறு என்பதன் பொருள் அணு	கரு என்பதன் பொருள் அணு
கறு என்பதன் பொருள் அடிப்படை	கரு என்பதன் பொருள் அடிப்படை
கரு என்பதன் பொருள் சினம்	கறு என்பதன் பொருள் சினம்
கரு என்பதன் பொருள் வைராக்கியம்	கறு என்பதன் பொருள் வைராக்கியம்
கரு என்பதன் பொருள் கோபம்	கறு என்பதன் பொருள் கோபம்
கரு என்பதன் பொருள் அகங்காரம்	கறு என்பதன் பொருள் அகங்காரம்
கறுப்பு என்பதன் பொருள் பஞ்சம்	கருப்பு என்பதன் பொருள் பஞ்சம்
கருப்பு என்பதன் பொருள் கருநிறம்	கறுப்பு என்பதன் பொருள் கருநிறம்
கருப்பு என்பதன் பொருள் பேய்	கறுப்பு என்பதன் பொருள் பேய்
கருப்பு என்பதன் பொருள் கோபம்	கறுப்பு என்பதன் பொருள் கோபம்
கருப்பு என்பதன் பொருள் குற்றம்	கறுப்பு என்பதன் பொருள் குற்றம்
கருப்பு என்பதன் பொருள் கறை	கறுப்பு என்பதன் பொருள் கறை
கறை என்பதன் பொருள் எல்லை	கரை என்பதன் பொருள் எல்லை
கறை என்பதன் பொருள் தடுப்பு	கரை என்பதன் பொருள் தடுப்பு
கறை என்பதன் பொருள் ஓரம்	கரை என்பதன் பொருள் ஓரம்
கரை என்பதன் பொருள் அழுக்கு	கறை என்பதன் பொருள் அழுக்கு
கரை என்பதன் பொருள் குற்றம்	கறை என்பதன் பொருள் குற்றம்
கரை என்பதன் பொருள் ரத்தம்	கறை என்பதன் பொருள் ரத்தம்
கறையான் என்பதன் பொருள் மீனவன்	கரையான் என்பதன் பொருள் மீனவன்
கரையான் ஓர் உயிரி	கறையான் ஓர் உயிரி
கற்பம் என்பதன் பொருள் கருவுறுதல்	கர்ப்பம் என்பதன் பொருள் கருவுறுதல்
கற்பம் என்பதன் பொருள் உள்	கர்ப்பம் என்பதன் பொருள் உள்
கற்பம் என்பதன் பொருள் சினை	கர்ப்பம் என்பதன் பொருள் சினை
கர்ப்பம் என்பதன் பொருள் கஞ்சா	கற்பம் என்பதன் பொருள் கஞ்சா
கர்ப்பம் என்பதன் பொருள் அற்பம்	கற்பம் என்பதன் பொருள் அற்பம்
கர்ப்பம் என்பதன் பொருள் ஊழிக்காலம்	கற்பம் என்பதன் பொருள் ஊழிக்காலம்
கர்ப்பம் என்பதன் பொருள் தேவலோகம்	கற்பம் என்பதன் பொருள் தேவலோகம்
கர்ப்பம் என்பதன் பொருள் திருநீறு	கற்பம் என்பதன் பொருள் திருநீறு
கர்ப்பம் என்பதன் பொருள் ஆயுள்	கற்பம் என்பதன் பொருள் ஆயுள்
கர்ப்பம் என்பதன் பொருள் மந்திர சாஸ்திரம்	கற்பம் என்பதன் பொருள் மந்திர சாஸ்திரம்
கர்ப்பம் என்பதன் பொருள் 432 கோடி	கற்பம் என்பதன் பொருள் 432 கோடி
கர்ப்பம் என்பதன் பொருள் மூப்பு நீக்கும் மருந்து	கற்பம் என்பதன் பொருள் மூப்பு நீக்கும் மருந்து
கற்பூரம் என்பதன் பொருள் சூடம்	கர்ப்பூரம் என்பதன் பொருள் சூடம்
கற்பூரம் என்பதன் பொருள் பொன்	கர்ப்பூரம் என்பதன் பொருள் பொன்
கற்பூரம் என்பதன் பொருள் மருந்து	கர்ப்பூரம் என்பதன் பொருள் மருந்து
கற்பூரம் என்பதன் பொருள் கூடம்	கர்ப்பூரம் என்பதன் பொருள் கூடம்
கர்ப்பூரம் என்பதன் பொருள் பொன்னாங்கண்ணி	கற்பூரம் என்பதன் பொருள் பொன்னாங்கண்ணி
காறி என்பதன் பொருள் கரிக்குருவி	காரி என்பதன் பொருள் கரிக்குருவி
காறி என்பதன் பொருள் காக்கை	காரி என்பதன் பொருள் காக்கை
காறி என்பதன் பொருள் வயிரவன்	காரி என்பதன் பொருள் வயிரவன்
காறி என்பதன் பொருள் ஐயனார்	காரி என்பதன் பொருள் ஐயனார்
காறி என்பதன் பொருள் ஒரு நதி	காரி என்பதன் பொருள் ஒரு நதி
காறி என்பதன் பொருள் சனி	காரி என்பதன் பொருள் சனி
காறி என்பதன் பொருள் விஷம்	காரி என்பதன் பொருள் விஷம்
காறி என்பதன் பொருள் ஒரு வள்ளல்	காரி என்பதன் பொருள் ஒரு வள்ளல்
காறி என்பதன் பொருள் வாசுதேவன்	காரி என்பதன் பொருள் வாசுதேவன்
காரி என்பதன் பொருள் காறிஉமிழும் கழிவு	காறி என்பதன் பொருள் காறிஉமிழும் கழிவு
காறு என்பதன் பொருள் வண்ணான்	காரு என்பதன் பொருள் வண்ணான்
காறு என்பதன் பொருள் தேவதச்சன்	காரு என்பதன் பொருள் தேவதச்சன்
காரு என்பதன் பொருள் காறி உமிழ்	காறு என்பதன் பொருள் காறி உமிழ்
காரு என்பதன் பொருள் அளவு	காறு என்பதன் பொருள் அளவு
காறை என்பதன் பொருள் ஒரு வகை செடி	காரை என்பதன் பொருள் ஒரு வகை செடி
காறை என்பதன் பொருள் ஒரு வகை மீன்	காரை என்பதன் பொருள் ஒரு வகை மீன்
காறை என்பதன் பொருள் சிமெண்ட் மணல் சேர்ந்த கலவை	காரை என்பதன் பொருள் சிமெண்ட் மணல் சேர்ந்த கலவை
காரை என்பதன் பொருள் ஒரு கழுத்தணி	காறை என்பதன் பொருள் ஒரு கழுத்தணி
கீறி ஓர் உயிரினம்	கீரி ஓர் உயிரினம்
கீரி என்பதன் பொருள் பிளந்து	கீறி என்பதன் பொருள் பிளந்து
கீரி என்பதன் பொருள் அரிந்து	கீறி என்பதன் பொருள் அரிந்து
குறங்கு என்பதன் பொருள் ஒரு விலங்கு	குரங்கு என்பதன் பொருள் ஒரு விலங்கு
குரங்கு என்பதன் பொருள் தொடை	குறங்கு என்பதன் பொருள் தொடை
குரங்கு என்பதன் பொருள் கொக்கி	குறங்கு என்பதன் பொருள் கொக்கி
குறவர் என்பதன் பொருள் கடவுள்	குரவர் என்பதன் பொருள் கடவுள்
குறவர் என்பதன் பொருள் குரு	குரவர் என்பதன் பொருள் குரு
குறவர் என்பதன் பொருள் பெரியோர்	குரவர் என்பதன் பொருள் பெரியோர்
குறவர் என்பதன் பொருள் அரசர்	குரவர் என்பதன் பொருள் அரசர்
குரவர் என்பதன் பொருள் ஒரு ஜாதியினர்	குறவர் என்பதன் பொருள் ஒரு ஜாதியினர்
குறவை என்பதன் பொருள் கூத்து வகை	குரவை என்பதன் பொருள் கூத்து வகை
குறவை என்பதன் பொருள் ஒலி	குரவை என்பதன் பொருள் ஒலி
குறவை என்பதன் பொருள் கடல்	குரவை என்பதன் பொருள் கடல்
குறவை என்பதன் பொருள் மகளிர் மகிழ்ச்சி	குரவை என்பதன் பொருள் மகளிர் மகிழ்ச்சி
குரவை என்பதன் பொருள் ஒருவகை மீன்	குறவை என்பதன் பொருள் ஒருவகை மீன்
குறத்தி என்பதன் பொருள் தலைவி	குரத்தி என்பதன் பொருள் தலைவி
குறத்தி என்பதன் பொருள் குருவின் மனைவி	குரத்தி என்பதன் பொருள் குருவின் மனைவி
குரத்தி என்பதன் பொருள் குறத்தி ஜாதிப் பெண்	குறத்தி என்பதன் பொருள் குறத்தி ஜாதிப் பெண்
குறுகு என்பதன் பொருள் பறவை	குருகு என்பதன் பொருள் பறவை
குறுகு என்பதன் பொருள் குட்டி	குருகு என்பதன் பொருள் குட்டி
குறுகு என்பதன் பொருள் கொக்கு	குருகு என்பதன் பொருள் கொக்கு
குறுகு என்பதன் பொருள் உலைத்துருத்தி	குருகு என்பதன் பொருள் உலைத்துருத்தி
குறுகு என்பதன் பொருள் உலைமூக்கு	குருகு என்பதன் பொருள் உலைமூக்கு
குறுகு என்பதன் பொருள் குருக்கத்தி	குருகு என்பதன் பொருள் குருக்கத்தி
குறுகு என்பதன் பொருள் நாரை	குருகு என்பதன் பொருள் நாரை
குறுகு என்பதன் பொருள் கோழி	குருகு என்பதன் பொருள் கோழி
குறுகு என்பதன் பொருள் கைவளை	குருகு என்பதன் பொருள் கைவளை
குருகு என்பதன் பொருள் அண்மைப்படுத்து	குறுகு என்பதன் பொருள் அண்மைப்படுத்து
குறுகினம் என்பதன் பொருள் பறவை இனம்	குருகினம் என்பதன் பொருள் பறவை இனம்
குருகினம் என்பதன் பொருள் நெருங்கினோம்	குறுகினம் என்பதன் பொருள் நெருங்கினோம்
குறை என்பதன் பொருள் சத்தம்	குரை என்பதன் பொருள் சத்தம்
குறை என்பதன் பொருள் ஒலி	குரை என்பதன் பொருள் ஒலி
குறை என்பதன் பொருள் குதிரை	குரை என்பதன் பொருள் குதிரை
குறை என்பதன் பொருள் பெருமை	குரை என்பதன் பொருள் பெருமை
குறை என்பதன் பொருள் ஓசை	குரை என்பதன் பொருள் ஓசை
குரை என்பதன் பொருள் குற்றம்	குறை என்பதன் பொருள் குற்றம்
குரை என்பதன் பொருள் காரியம்	குறை என்பதன் பொருள் காரியம்
குரை என்பதன் பொருள் கடன்	குறை என்பதன் பொருள் கடன்
குரை என்பதன் பொருள் வேண்டுகோள்	குறை என்பதன் பொருள் வேண்டுகோள்
குரை என்பதன் பொருள் வறுமை	குறை என்பதன் பொருள் வறுமை
குறு என்பதன் பொருள் ஆசிரியர்	குரு என்பதன் பொருள் ஆசிரியர்
குறு என்பதன் பொருள் மேன்மை	குரு என்பதன் பொருள் மேன்மை
குறு என்பதன் பொருள் கனம்	குரு என்பதன் பொருள் கனம்
குறு என்பதன் பொருள் வியாழன்	குரு என்பதன் பொருள் வியாழன்
குறு என்பதன் பொருள் நிறம்	குரு என்பதன் பொருள் நிறம்
குறு என்பதன் பொருள் தந்தை	குரு என்பதன் பொருள் தந்தை
குறு என்பதன் பொருள் இரசம்	குரு என்பதன் பொருள் இரசம்
குரு என்பதன் பொருள் குறுகு	குறு என்பதன் பொருள் குறுகு
கூறல் என்பதன் பொருள் ஒரு மீன்	கூரல் என்பதன் பொருள் ஒரு மீன்
கூறல் என்பதன் பொருள் பறவை இறகு	கூரல் என்பதன் பொருள் பறவை இறகு
கூரல் என்பதன் பொருள் சொல்லுதல்	கூறல் என்பதன் பொருள் சொல்லுதல்
கூரல் என்பதன் பொருள் விற்றல்	கூறல் என்பதன் பொருள் விற்றல்
கூறை என்பதன் பொருள் சிறிய ஓலை வீடு	கூரை என்பதன் பொருள் சிறிய ஓலை வீடு
கூறை என்பதன் பொருள் வீட்டின் மேற்கூரை	கூரை என்பதன் பொருள் வீட்டின் மேற்கூரை
கூறை என்பதன் பொருள் சிற்றில்	கூரை என்பதன் பொருள் சிற்றில்
கூரை என்பதன் பொருள் புது ஆடை	கூறை என்பதன் பொருள் புது ஆடை
கூரை என்பதன் பொருள் சீலை	கூறை என்பதன் பொருள் சீலை
கூறிய என்பதன் பொருள் கூர்மையான	கூரிய என்பதன் பொருள் கூர்மையான
கூரிய என்பதன் பொருள் சொன்ன	கூறிய என்பதன் பொருள் சொன்ன
கூற என்பதன் பொருள் குளிர்ச்சி மிக	கூர என்பதன் பொருள் குளிர்ச்சி மிக
கூர என்பதன் பொருள் சொல்ல	கூற என்பதன் பொருள் சொல்ல
கூர என்பதன் பொருள் வேண்டல்	கூற என்பதன் பொருள் வேண்டல்
கோறல் என்பதன் பொருள் கூறுதல்	கோரல் என்பதன் பொருள் கூறுதல்
கோரல் என்பதன் பொருள் கொல்லல்	கோறல் என்பதன் பொருள் கொல்லல்
கோறை என்பதன் பொருள் புல்வகை	கோரை என்பதன் பொருள் புல்வகை
கோரை என்பதன் பொருள் குவளை	கோறை என்பதன் பொருள் குவளை
கோரை என்பதன் பொருள் பொந்து	கோறை என்பதன் பொருள் பொந்து
கோறல் என்பதன் பொருள் சேர்தல்	கோரல் என்பதன் பொருள் சேர்தல்
கோறல் என்பதன் பொருள் குளிர் காற்று	கோரல் என்பதன் பொருள் குளிர் காற்று
கோறல் என்பதன் பொருள் மலைப்பக்கம்	கோரல் என்பதன் பொருள் மலைப்பக்கம்
கோரல் என்பதன் பொருள் குளிர் காற்று	கோறல் என்பதன் பொருள் குளிர் காற்று
கோரல் என்பதன் பொருள் மழை	கோறல் என்பதன் பொருள் மழை
சிறை என்பதன் பொருள் சிரைத்தல்	சிரை என்பதன் பொருள் சிரைத்தல்
சிறை என்பதன் பொருள் முடிநீக்கல்	சிரை என்பதன் பொருள் முடிநீக்கல்
சிரை என்பதன் பொருள் சிறைச்சாலை	சிறை என்பதன் பொருள் சிறைச்சாலை
சிரை என்பதன் பொருள் மதில்	சிறை என்பதன் பொருள் மதில்
சிரை என்பதன் பொருள் காவல்	சிறை என்பதன் பொருள் காவல்
சிரை என்பதன் பொருள் பக்கம்	சிறை என்பதன் பொருள் பக்கம்
சிரை என்பதன் பொருள் நீர்க்கரை	சிறை என்பதன் பொருள் நீர்க்கரை
சிரை என்பதன் பொருள் இறகு	சிறை என்பதன் பொருள் இறகு
சிரை என்பதன் பொருள் அடிமை	சிறை என்பதன் பொருள் அடிமை
சிரை என்பதன் பொருள் அறை	சிறை என்பதன் பொருள் அறை
சிரை என்பதன் பொருள் அணை	சிறை என்பதன் பொருள் அணை
சீறிய என்பதன் பொருள் சினந்த	சீரிய என்பதன் பொருள் சினந்த
சீறிய என்பதன் பொருள்​​ சிறந்த,​	சீரிய என்பதன் பொருள்​​ சிறந்த,​
சீறிய என்பதன் பொருள் சீராய்​	சீரிய என்பதன் பொருள் சீராய்​
சீரிய என்பதன் பொருள் சினந்த	சீறிய என்பதன் பொருள் சினந்த
சுறா​​ என்பதன் பொருள் கள்​	சுரா​ என்பதன் பொருள் கள்​
சுரா​ என்பதன் பொருள் சுறா மீன்	சுறா​ என்பதன் பொருள் சுறா மீன்
சூறல்​ என்பதன் பொருள் மூங்​கில்,​​ பிரம்பு​	சூரல்​ என்பதன் பொருள் மூங்​கில்,​​ பிரம்பு​
சூரல்​ என்பதன் பொருள்​ தோண்​டல்	சூறல்​ என்பதன் பொருள்​ தோண்​டல்
சுறுக்கு​ என்பதன் பொருள்​ வலை	சுருக்கு​ என்பதன் பொருள்​ வலை
சுறுக்கு​ என்பதன் பொருள்​​ சுருக்​கம்	சுருக்கு​ என்பதன் பொருள்​​ சுருக்​கம்
சுறுக்கு​ என்பதன் பொருள்​​ கட்டு	சுருக்கு​ என்பதன் பொருள்​​ கட்டு
சுறுக்கு​ என்பதன் பொருள்​​ பூமாலை	சுருக்கு​ என்பதன் பொருள்​​ பூமாலை
சுறுக்கு​ என்பதன் பொருள் வகை	சுருக்கு​ என்பதன் பொருள் வகை
சுறுக்கு​ என்பதன் பொருள்​​ குறைவு	சுருக்கு​ என்பதன் பொருள்​​ குறைவு
சுறுக்கு​ என்பதன் பொருள் நெய்த்​து​டுப்பு​	சுருக்கு​ என்பதன் பொருள் நெய்த்​து​டுப்பு​
சுருக்கு​ என்பதன் பொருள் விரைவு	சுறுக்கு​ என்பதன் பொருள் விரைவு
செறு​ என்பதன் பொருள் போர்	செரு​ என்பதன் பொருள் போர்
செறு​​ என்பதன் பொருள் ஊடல்	செரு​ என்பதன் பொருள் ஊடல்
செரு​​ என்பதன் பொருள்​ வயல்	செறு​ என்பதன் பொருள்​ வயல்
செரு​​ என்பதன் பொருள்​​ பாத்தி	செறு​ என்பதன் பொருள்​​ பாத்தி
செரு​​ என்பதன் பொருள்​​ குளம்	செறு​ என்பதன் பொருள்​​ குளம்
செறு​நர்​​ என்பதன் பொருள் பகை​வர்	செரு​நர்​ என்பதன் பொருள் பகை​வர்
செறு​நர்​​ என்பதன் பொருள்​​ படை​வீ​ரர்​	செரு​நர்​ என்பதன் பொருள்​​ படை​வீ​ரர்​
செரு​நர்​ என்பதன் பொருள்​ பகை​வர்	செறு​நர்​ என்பதன் பொருள்​ பகை​வர்
சொறி​ என்பதன் பொருள்​ தினவு	சொரி​ என்பதன் பொருள்​ தினவு
சொறி​ என்பதன் பொருள் அரிப்பு	சொரி​ என்பதன் பொருள் அரிப்பு
சொறி என்பதன் பொருள் பொழி	சொரி​ என்பதன் பொருள் பொழி
சொரி என்பதன் பொருள்​ சிரங்கு	சொறி என்பதன் பொருள்​ சிரங்கு
சொரி என்பதன் பொருள் சொறி​தல்	சொறி என்பதன் பொருள் சொறி​தல்
தறித்​தல்​ என்பதன் பொருள் அணி​தல்	தரித்​தல்​ என்பதன் பொருள் அணி​தல்
தறித்​தல்​ என்பதன் பொருள்​​ பொறுத்​தல்	தரித்​தல்​ என்பதன் பொருள்​​ பொறுத்​தல்
தறித்​தல்​ என்பதன் பொருள் தங்​கல்	தரித்​தல்​ என்பதன் பொருள் தங்​கல்
தறித்​தல்​ என்பதன் பொருள் தாம​தித்​தல்	தரித்​தல்​ என்பதன் பொருள் தாம​தித்​தல்
தறித்​தல் என்பதன் பொருள் தாங்​கு​தல்​	தரித்​தல்​ என்பதன் பொருள் தாங்​கு​தல்​
தரித்​தல் என்பதன் பொருள் வெட்​டு​தல்	தறித்​தல் என்பதன் பொருள் வெட்​டு​தல்
தறி​ என்பதன் பொருள் அணி	தரி​ என்பதன் பொருள் அணி
தறி​ என்பதன் பொருள் அணிந்​து ​கொள்​	தரி​ என்பதன் பொருள் அணிந்​து ​கொள்​
தரி என்பதன் பொருள் தூண்	தறி என்பதன் பொருள் தூண்
தரி என்பதன் பொருள் ஆப்பு	தறி என்பதன் பொருள் ஆப்பு
தரி என்பதன் பொருள் நெசவு இயந்​தி​ரம்	தறி என்பதன் பொருள் நெசவு இயந்​தி​ரம்
தரி என்பதன் பொருள் முளைக்​கோல்	தறி என்பதன் பொருள் முளைக்​கோல்
தறு​தல் என்பதன் பொருள்​ கொடுத்​தல்​	தரு​தல் என்பதன் பொருள்​ கொடுத்​தல்​
தரு​தல்​ என்பதன் பொருள் இறு​கக்​ கட்​டு​தல்	தறு​தல்​ என்பதன் பொருள் இறு​கக்​ கட்​டு​தல்
தாறு​​ என்பதன் பொருள் மரம்	தாரு​ என்பதன் பொருள் மரம்
தாறு​​ என்பதன் பொருள் தேவ​தாரு	தாரு​ என்பதன் பொருள் தேவ​தாரு
தாறு​​ என்பதன் பொருள் பித்​தளை	தாரு​ என்பதன் பொருள் பித்​தளை
தாரு​ என்பதன் பொருள்​ குலை	தாறு​ என்பதன் பொருள்​ குலை
தாரு​ என்பதன் பொருள்​​ அங்​கு​சம்	தாறு​ என்பதன் பொருள்​​ அங்​கு​சம்
தாரு​ என்பதன் பொருள்​​ முள்	தாறு​ என்பதன் பொருள்​​ முள்
தாரு​ என்பதன் பொருள் இரும்பு	தாறு​ என்பதன் பொருள் இரும்பு
தாரு​ என்பதன் பொருள் முள்​கோல்	தாறு​ என்பதன் பொருள் முள்​கோல்
திறம்​ என்பதன் பொருள் மலை	திரம்​ என்பதன் பொருள் மலை
திறம்​ என்பதன் பொருள்​​ உறுதி	திரம்​ என்பதன் பொருள்​​ உறுதி
திறம்​ என்பதன் பொருள்​​ நிலை	திரம்​ என்பதன் பொருள்​​ நிலை
திறம்​ என்பதன் பொருள் பூமி​	திரம்​ என்பதன் பொருள் பூமி​
திரம்​ என்பதன் பொருள் உறுதி	திறம்​ என்பதன் பொருள் உறுதி
திரம்​ என்பதன் பொருள் நரம்​புள்ள வீணை	திறம்​ என்பதன் பொருள் நரம்​புள்ள வீணை
திரம்​ என்பதன் பொருள் கூறு​பாடு	திறம்​ என்பதன் பொருள் கூறு​பாடு
திரம்​ என்பதன் பொருள்​​ சுற்​றம்	திறம்​ என்பதன் பொருள்​​ சுற்​றம்
திரம்​ என்பதன் பொருள்​​ குலம்	திறம்​ என்பதன் பொருள்​​ குலம்
திரம்​ என்பதன் பொருள்​​ பக்​கம்	திறம்​ என்பதன் பொருள்​​ பக்​கம்
திரம் என்பதன் பொருள் வல்​லமை	திறம்​ என்பதன் பொருள் வல்​லமை
திரம்​ என்பதன் பொருள் ஒழுக்​கம்	திறம்​ என்பதன் பொருள் ஒழுக்​கம்
திரம்​ என்பதன் பொருள்​​ மேன்மை	திறம்​ என்பதன் பொருள்​​ மேன்மை
திரம்​ என்பதன் பொருள் வர​லாறு	திறம்​ என்பதன் பொருள் வர​லாறு
திரம்​ என்பதன் பொருள்​​ கார​ணம்	திறம்​ என்பதன் பொருள்​​ கார​ணம்
திறை​ என்பதன் பொருள் அலை	திரை​ என்பதன் பொருள் அலை
திறை​ என்பதன் பொருள்​​ கடல்	திரை​ என்பதன் பொருள்​​ கடல்
திறை​ என்பதன் பொருள்​​ திரைச் ​சீலை	திரை​ என்பதன் பொருள்​​ திரைச் ​சீலை
திரை​ என்பதன் பொருள்​ கப்​பம்	திறை​ என்பதன் பொருள்​ கப்​பம்
துறவு​​ என்பதன் பொருள்​ கிணறு​	துரவு​ என்பதன் பொருள்​ கிணறு​
துரவு​ என்பதன் பொருள் துறத்​தல்	துறவு​ என்பதன் பொருள் துறத்​தல்
துரவு​ என்பதன் பொருள்​​ துற​வ​றம்	துறவு​ என்பதன் பொருள்​​ துற​வ​றம்
துறை​ என்பதன் பொருள் பெரி​யோன்	துரை​ என்பதன் பொருள் பெரி​யோன்
துறை​ என்பதன் பொருள்​​ தலை​வன்	துரை​ என்பதன் பொருள்​​ தலை​வன்
துரை​ என்பதன் பொருள் நீர்த்​துறை	துறை​ என்பதன் பொருள் நீர்த்​துறை
துரை​ என்பதன் பொருள் வழி	துறை​ என்பதன் பொருள் வழி
துரை என்பதன் பொருள் இடம்	துறை​ என்பதன் பொருள் இடம்
துரை என்பதன் பொருள்​​ நூல்	துறை​ என்பதன் பொருள்​​ நூல்
துரை​ என்பதன் பொருள்​​ கடற்​கரை	துறை​ என்பதன் பொருள்​​ கடற்​கரை
துரை​ என்பதன் பொருள் உபா​யம்	துறை​ என்பதன் பொருள் உபா​யம்
துரை​ என்பதன் பொருள் பாவி​னம்	துறை​ என்பதன் பொருள் பாவி​னம்
துறு​ என்பதன் பொருள்​ களிம்பு	துரு​ என்பதன் பொருள்​ களிம்பு
துரு​ என்பதன் பொருள் கூட்​டம்	துறு​ என்பதன் பொருள் கூட்​டம்
துரு என்பதன் பொருள் நெருக்​கம்	துறு​ என்பதன் பொருள் நெருக்​கம்
தூறல்​ என்பதன் பொருள்​ தூரு​தல்	தூரல்​ என்பதன் பொருள்​ தூரு​தல்
தூறல் என்பதன் பொருள்​​​ வருத்​தம்	தூரல்​ என்பதன் பொருள்​​​ வருத்​தம்
தூரல்​ என்பதன் பொருள் மழைத்​துளி	தூறல்​ என்பதன் பொருள் மழைத்​துளி
தூரல்​ என்பதன் பொருள் பழி சொல்​லு​தல்	தூறல்​ என்பதன் பொருள் பழி சொல்​லு​தல்
தூறன் என்பதன் பொருள் குலத்​தின் பெயர்	தூரன்​ என்பதன் பொருள் குலத்​தின் பெயர்
தூரன்​​ என்பதன் பொருள்​ மூர்க்​கன்	தூறன்​ என்பதன் பொருள்​ மூர்க்​கன்
துறு​ என்பதன் பொருள் வீதி	துரு​ என்பதன் பொருள் வீதி
துரு​ என்பதன் பொருள்​ உண்	துறு​ என்பதன் பொருள்​ உண்
தேறார்​ என்பதன் பொருள்​ கல்​லா​த​வர்	தேரார்​ என்பதன் பொருள்​ கல்​லா​த​வர்
தேறார்​ என்பதன் பொருள்​​ கீழ்​மக்​கள்	தேரார்​ என்பதன் பொருள்​​ கீழ்​மக்​கள்
தேறார்​ என்பதன் பொருள் பகை​வர்​	தேரார்​ என்பதன் பொருள் பகை​வர்​
தேரார்​ என்பதன் பொருள் அறி​வி​லார்	தேறார்​ என்பதன் பொருள் அறி​வி​லார்
தேரார்​ என்பதன் பொருள் பகை​வர்	தேறார்​ என்பதன் பொருள் பகை​வர்
தேறி என்பதன் பொருள் மணல் திட்டை	தேரி என்பதன் பொருள் மணல் திட்டை
தேறி என்பதன் பொருள் மணல் குன்று	தேரி என்பதன் பொருள் மணல் குன்று
தேரி என்பதன் பொருள் தேர்ச்சி பெற்று	தேறி என்பதன் பொருள் தேர்ச்சி பெற்று
தேரி என்பதன் பொருள் தெளிந்து	தேறி என்பதன் பொருள் தெளிந்து
நறை என்பதன் பொருள் நரைமுடி	நரை என்பதன் பொருள் நரைமுடி
நறை என்பதன் பொருள் வெண் மயிர்	நரை என்பதன் பொருள் வெண் மயிர்
நறை என்பதன் பொருள் மூப்பு	நரை என்பதன் பொருள் மூப்பு
நறை என்பதன் பொருள் எருது	நரை என்பதன் பொருள் எருது
நறை என்பதன் பொருள் கவரிமா	நரை என்பதன் பொருள் கவரிமா
நறை என்பதன் பொருள் மரச்சொத்தை	நரை என்பதன் பொருள் மரச்சொத்தை
நறை என்பதன் பொருள் பெருமை	நரை என்பதன் பொருள் பெருமை
நரை என்பதன் பொருள் தேன்	நறை என்பதன் பொருள் தேன்
நரை என்பதன் பொருள் சாதிக்காய்	நறை என்பதன் பொருள் சாதிக்காய்
நரை என்பதன் பொருள் கள்	நறை என்பதன் பொருள் கள்
நரை என்பதன் பொருள் வாசனை	நறை என்பதன் பொருள் வாசனை
நரை என்பதன் பொருள் நறும்புகை	நறை என்பதன் பொருள் நறும்புகை
நரை என்பதன் பொருள் பச்சிலைக் கொடி	நறை என்பதன் பொருள் பச்சிலைக் கொடி
நரை என்பதன் பொருள் குற்றம்	நறை என்பதன் பொருள் குற்றம்
நாறி என்பதன் பொருள் பெண்	நாரி என்பதன் பொருள் பெண்
நாறி என்பதன் பொருள் பார்வதி	நாரி என்பதன் பொருள் பார்வதி
நாறி என்பதன் பொருள் வாசனை	நாரி என்பதன் பொருள் வாசனை
நாறி என்பதன் பொருள் கள்	நாரி என்பதன் பொருள் கள்
நாறி என்பதன் பொருள் சேனை	நாரி என்பதன் பொருள் சேனை
நாறி என்பதன் பொருள் பன்னாடை	நாரி என்பதன் பொருள் பன்னாடை
நாறி என்பதன் பொருள் தேன்	நாரி என்பதன் பொருள் தேன்
நாரி என்பதன் பொருள் கற்றாழை	நாறி என்பதன் பொருள் கற்றாழை
நிறுத்தம் என்பதன் பொருள் கூத்து	நிருத்தம் என்பதன் பொருள் கூத்து
நிறுத்தம் என்பதன் பொருள் நடனம்	நிருத்தம் என்பதன் பொருள் நடனம்
நிறுத்தம் என்பதன் பொருள் பதம் பிரித்துப் பொருள் கூறும் நூல்	நிருத்தம் என்பதன் பொருள் பதம் பிரித்துப் பொருள் கூறும் நூல்
நிறுத்தம் என்பதன் பொருள் பற்றின்மை	நிருத்தம் என்பதன் பொருள் பற்றின்மை
நிருத்தம் என்பதன் பொருள் நிறுத்தும் இடம்	நிறுத்தம் என்பதன் பொருள் நிறுத்தும் இடம்
நிறை என்பதன் பொருள் பசு	நிரை என்பதன் பொருள் பசு
நிறை என்பதன் பொருள் ஒழுங்கு	நிரை என்பதன் பொருள் ஒழுங்கு
நிறை என்பதன் பொருள் வரிசை	நிரை என்பதன் பொருள் வரிசை
நிரை என்பதன் பொருள் கற்பு	நிறை என்பதன் பொருள் கற்பு
நிரை என்பதன் பொருள் அளவு	நிறை என்பதன் பொருள் அளவு
நிரை என்பதன் பொருள் அழிவின்மை	நிறை என்பதன் பொருள் அழிவின்மை
நிரை என்பதன் பொருள் நீதி	நிறை என்பதன் பொருள் நீதி
நிரை என்பதன் பொருள் வரையறை	நிறை என்பதன் பொருள் வரையறை
நிரை என்பதன் பொருள் திண்மை	நிறை என்பதன் பொருள் திண்மை
நிரை என்பதன் பொருள் நிரப்பு	நிறை என்பதன் பொருள் நிரப்பு
நூறல் என்பதன் பொருள் அவிதல்	நூரல் என்பதன் பொருள் அவிதல்
நூறல் என்பதன் பொருள் பதங்கெடுதல்	நூரல் என்பதன் பொருள் பதங்கெடுதல்
நூரல் என்பதன் பொருள் அவித்தல்	நூறல் என்பதன் பொருள் அவித்தல்
நேறி என்பதன் பொருள் அமுக்கு	நேரி என்பதன் பொருள் அமுக்கு
நேறி என்பதன் பொருள் நசுக்கு	நேரி என்பதன் பொருள் நசுக்கு
நேறி என்பதன் பொருள் அழுத்து	நேரி என்பதன் பொருள் அழுத்து
நேரி என்பதன் பொருள் வழி	நேறி என்பதன் பொருள் வழி
நேரி என்பதன் பொருள் கோயில்	நேறி என்பதன் பொருள் கோயில்
நேரி என்பதன் பொருள் கற்பு	நேறி என்பதன் பொருள் கற்பு
பறட்டை என்பதன் பொருள் பரட்டைத்தலை	பரட்டை என்பதன் பொருள் பரட்டைத்தலை
பரட்டை என்பதன் பொருள் செழிப்பற்றது	பறட்டை என்பதன் பொருள் செழிப்பற்றது
பறதி என்பதன் பொருள் கூத்தாடுபவன்	பரதி என்பதன் பொருள் கூத்தாடுபவன்
பரதி என்பதன் பொருள் அவசரம்	பறதி என்பதன் பொருள் அவசரம்
பரதி என்பதன் பொருள் பறத்தல்	பறதி என்பதன் பொருள் பறத்தல்
பறத்தல் என்பதன் பொருள் அலமறுதல்	பரத்தல் என்பதன் பொருள் அலமறுதல்
பறத்தல் என்பதன் பொருள் மிகுதல்	பரத்தல் என்பதன் பொருள் மிகுதல்
பரத்தல் என்பதன் பொருள் பறந்து செல்லல்	பறத்தல் என்பதன் பொருள் பறந்து செல்லல்
பறம்பு என்பதன் பொருள் வயலை சமப்படுத்தும் பலகை	பரம்பு என்பதன் பொருள் வயலை சமப்படுத்தும் பலகை
பரம்பு என்பதன் பொருள் பாரியின் மலை	பறம்பு என்பதன் பொருள் பாரியின் மலை
பறல் என்பதன் பொருள் விதை	பரல் என்பதன் பொருள் விதை
பறல் என்பதன் பொருள் பருக்கைக்கல்	பரல் என்பதன் பொருள் பருக்கைக்கல்
பரல் என்பதன் பொருள் பறவை	பறல் என்பதன் பொருள் பறவை
பறவை என்பதன் பொருள் கடல்	பரவை என்பதன் பொருள் கடல்
பறவை என்பதன் பொருள் ஆடல்	பரவை என்பதன் பொருள் ஆடல்
பறவை என்பதன் பொருள் பரப்பு	பரவை என்பதன் பொருள் பரப்பு
பரவை என்பதன் பொருள் பறப்பவை	பறவை என்பதன் பொருள் பறப்பவை
பரவை என்பதன் பொருள் ஒரு நோய்	பறவை என்பதன் பொருள் ஒரு நோய்
பறி என்பதன் பொருள் குதிரை	பரி என்பதன் பொருள் குதிரை
பறி என்பதன் பொருள் பெருமை	பரி என்பதன் பொருள் பெருமை
பறி என்பதன் பொருள் விரைவு	பரி என்பதன் பொருள் விரைவு
பறி என்பதன் பொருள் செலவு	பரி என்பதன் பொருள் செலவு
பறி என்பதன் பொருள் சுமை	பரி என்பதன் பொருள் சுமை
பறி என்பதன் பொருள் மிகுதி	பரி என்பதன் பொருள் மிகுதி
பரி என்பதன் பொருள் பறித்தல்	பறி என்பதன் பொருள் பறித்தல்
பரி என்பதன் பொருள் கொள்ளை	பறி என்பதன் பொருள் கொள்ளை
பரி என்பதன் பொருள் பொன்	பறி என்பதன் பொருள் பொன்
பரி என்பதன் பொருள் வலை	பறி என்பதன் பொருள் வலை
பரி என்பதன் பொருள் உடம்பு	பறி என்பதன் பொருள் உடம்பு
பரி என்பதன் பொருள் ஓலைப்பாய்	பறி என்பதன் பொருள் ஓலைப்பாய்
பறித்தல் என்பதன் பொருள் காத்தல்	பரித்தல் என்பதன் பொருள் காத்தல்
பறித்தல் என்பதன் பொருள் ஓடுதல்	பரித்தல் என்பதன் பொருள் ஓடுதல்
பறித்தல் என்பதன் பொருள் தாங்குதல்	பரித்தல் என்பதன் பொருள் தாங்குதல்
பறித்தல் என்பதன் பொருள் சுமத்தல்	பரித்தல் என்பதன் பொருள் சுமத்தல்
பறித்தல் என்பதன் பொருள் சூழ்தல்	பரித்தல் என்பதன் பொருள் சூழ்தல்
பறித்தல் என்பதன் பொருள் தரித்தல்	பரித்தல் என்பதன் பொருள் தரித்தல்
பரித்தல் என்பதன் பொருள் பிடுங்குதல்	பறித்தல் என்பதன் பொருள் பிடுங்குதல்
பறிவு என்பதன் பொருள் அன்பு	பரிவு என்பதன் பொருள் அன்பு
பறிவு என்பதன் பொருள் துன்பம்	பரிவு என்பதன் பொருள் துன்பம்
பறிவு என்பதன் பொருள் இரக்கம்	பரிவு என்பதன் பொருள் இரக்கம்
பரிவு என்பதன் பொருள் கழிவு	பறிவு என்பதன் பொருள் கழிவு
பரிவு என்பதன் பொருள் அதிர்தல்	பறிவு என்பதன் பொருள் அதிர்தல்
பறுகு என்பதன் பொருள் குடி	பருகு என்பதன் பொருள் குடி
பறுகு என்பதன் பொருள் அருந்து	பருகு என்பதன் பொருள் அருந்து
பருகு என்பதன் பொருள் பறட்டை	பறுகு என்பதன் பொருள் பறட்டை
பருகு என்பதன் பொருள் அன்பு	பறுகு என்பதன் பொருள் அன்பு
பருகு என்பதன் பொருள் பக்குவம்	பறுகு என்பதன் பொருள் பக்குவம்
பறை என்பதன் பொருள் சிவசக்தி	பரை என்பதன் பொருள் சிவசக்தி
பரை என்பதன் பொருள் இசைக்கருவி	பறை என்பதன் பொருள் இசைக்கருவி
பரை என்பதன் பொருள் இறகு	பறை என்பதன் பொருள் இறகு
பரை என்பதன் பொருள் வாத்தியம்	பறை என்பதன் பொருள் வாத்தியம்
பரை என்பதன் பொருள் பறவை	பறை என்பதன் பொருள் பறவை
பரை என்பதன் பொருள் சொல்	பறை என்பதன் பொருள் சொல்
பாறை என்பதன் பொருள் கடப்பாரை	பாரை என்பதன் பொருள் கடப்பாரை
பாரை என்பதன் பொருள் கற்பாறை	பாறை என்பதன் பொருள் கற்பாறை
பிறை என்பதன் பொருள் உறைமோர்	பிரை என்பதன் பொருள் உறைமோர்
பிறை என்பதன் பொருள் பயன்	பிரை என்பதன் பொருள் பயன்
பிரை என்பதன் பொருள் பிறைச்சந்திரன்	பிறை என்பதன் பொருள் பிறைச்சந்திரன்
பீறு என்பதன் பொருள் புருவம்	பீரு என்பதன் பொருள் புருவம்
பீறு என்பதன் பொருள் அச்சமுள்ளோன்	பீரு என்பதன் பொருள் அச்சமுள்ளோன்
பீரு என்பதன் பொருள் கிழிவு	பீறு என்பதன் பொருள் கிழிவு
புறம் என்பதன் பொருள் மாடம்	புரம் என்பதன் பொருள் மாடம்
புறம் என்பதன் பொருள் கோயில்	புரம் என்பதன் பொருள் கோயில்
புறம் என்பதன் பொருள் இராஜதானி	புரம் என்பதன் பொருள் இராஜதானி
புறம் என்பதன் பொருள் ஊர்	புரம் என்பதன் பொருள் ஊர்
புறம் என்பதன் பொருள் முன்	புரம் என்பதன் பொருள் முன்
புறம் என்பதன் பொருள் மேல்மாடம்	புரம் என்பதன் பொருள் மேல்மாடம்
புறம் என்பதன் பொருள் ஒரு நகரம்	புரம் என்பதன் பொருள் ஒரு நகரம்
புரம் என்பதன் பொருள் இடம்	புறம் என்பதன் பொருள் இடம்
புரம் என்பதன் பொருள் வரியில்லா நிலம்	புறம் என்பதன் பொருள் வரியில்லா நிலம்
புரம் என்பதன் பொருள் பக்கம்	புறம் என்பதன் பொருள் பக்கம்
புரம் என்பதன் பொருள் வெளி	புறம் என்பதன் பொருள் வெளி
புரம் என்பதன் பொருள் பின்புறம்	புறம் என்பதன் பொருள் பின்புறம்
புரம் என்பதன் பொருள் முதுகு	புறம் என்பதன் பொருள் முதுகு
பெறுக்கல் என்பதன் பொருள் நிறைத்தல்	பெருக்கல் என்பதன் பொருள் நிறைத்தல்
பெறுக்கல் என்பதன் பொருள் மிகுத்தல்	பெருக்கல் என்பதன் பொருள் மிகுத்தல்
பெறுக்கல் என்பதன் பொருள் நிரப்புதல்	பெருக்கல் என்பதன் பொருள் நிரப்புதல்
பெறுக்கல் என்பதன் பொருள் அதிகப்படுத்தல்	பெருக்கல் என்பதன் பொருள் அதிகப்படுத்தல்
பெறுக்கல் என்பதன் பொருள் மிகுவித்தல்	பெருக்கல் என்பதன் பொருள் மிகுவித்தல்
பெருக்கல் என்பதன் பொருள் அரிசி	பெறுக்கல் என்பதன் பொருள் அரிசி
பெருக்கல் என்பதன் பொருள் மிகுத்தல்	பெறுக்கல் என்பதன் பொருள் மிகுத்தல்
பொறி என்பதன் பொருள் நெற்பொரி	பொரி என்பதன் பொருள் நெற்பொரி
பொறி என்பதன் பொருள் பொரிதல்	பொரி என்பதன் பொருள் பொரிதல்
பொரி என்பதன் பொருள் தீப்பொறி	பொறி என்பதன் பொருள் தீப்பொறி
பொரி என்பதன் பொருள் அறிவு	பொறி என்பதன் பொருள் அறிவு
பொரி என்பதன் பொருள் எழுந்து	பொறி என்பதன் பொருள் எழுந்து
பொரி என்பதன் பொருள் வரிவண்டு	பொறி என்பதன் பொருள் வரிவண்டு
பொறித்தல் என்பதன் பொருள் வறுத்தல்	பொரித்தல் என்பதன் பொருள் வறுத்தல்
பொறித்தல் என்பதன் பொருள் குஞ்சு பொரித்தல்	பொரித்தல் என்பதன் பொருள் குஞ்சு பொரித்தல்
பொரித்தல் என்பதன் பொருள் எழுதுதல்	பொறித்தல் என்பதன் பொருள் எழுதுதல்
பொரித்தல் என்பதன் பொருள் தீட்டுதல்	பொறித்தல் என்பதன் பொருள் தீட்டுதல்
பொரித்தல் என்பதன் பொருள் பதித்தல்	பொறித்தல் என்பதன் பொருள் பதித்தல்
பொரித்தல் என்பதன் பொருள் அடையாளமாக வைத்தல்	பொறித்தல் என்பதன் பொருள் அடையாளமாக வைத்தல்
பொறுப்பு என்பதன் பொருள் மலை	பொருப்பு என்பதன் பொருள் மலை
பொறுப்பு என்பதன் பொருள் பக்கமலை	பொருப்பு என்பதன் பொருள் பக்கமலை
பொருப்பு என்பதன் பொருள் பாரம்	பொறுப்பு என்பதன் பொருள் பாரம்
பொருப்பு என்பதன் பொருள் பொறுமை	பொறுப்பு என்பதன் பொருள் பொறுமை
பொறு என்பதன் பொருள் போர்	பொரு என்பதன் பொருள் போர்
பொரு என்பதன் பொருள் பொறுத்திரு	பொறு என்பதன் பொருள் பொறுத்திரு
மறத்தல் என்பதன் பொருள் விறைத்தல்	மரத்தல் என்பதன் பொருள் விறைத்தல்
மரத்தல் என்பதன் பொருள் மறதி	மறத்தல் என்பதன் பொருள் மறதி
மரத்தல் என்பதன் பொருள் நினைவின்மை	மறத்தல் என்பதன் பொருள் நினைவின்மை
மறம் என்பதன் பொருள் தாவர வகை	மரம் என்பதன் பொருள் தாவர வகை
மறம் என்பதன் பொருள் மூலிகை	மரம் என்பதன் பொருள் மூலிகை
மறம் என்பதன் பொருள் மரக்கலம்	மரம் என்பதன் பொருள் மரக்கலம்
மரம் என்பதன் பொருள் வீரம்	மறம் என்பதன் பொருள் வீரம்
மரம் என்பதன் பொருள் போர்	மறம் என்பதன் பொருள் போர்
மரம் என்பதன் பொருள் சினம்	மறம் என்பதன் பொருள் சினம்
மரம் என்பதன் பொருள் மாறுபாடு	மறம் என்பதன் பொருள் மாறுபாடு
மரம் என்பதன் பொருள் கொலை	மறம் என்பதன் பொருள் கொலை
மரம் என்பதன் பொருள் பாவம்	மறம் என்பதன் பொருள் பாவம்
மரம் என்பதன் பொருள் வலி	மறம் என்பதன் பொருள் வலி
மரம் என்பதன் பொருள் கொடுமை	மறம் என்பதன் பொருள் கொடுமை
மரம் என்பதன் பொருள் மயக்கம்	மறம் என்பதன் பொருள் மயக்கம்
மறி என்பதன் பொருள் விலங்குகளின் குட்டி	மரி என்பதன் பொருள் விலங்குகளின் குட்டி
மரி என்பதன் பொருள் தடை செய்	மறி என்பதன் பொருள் தடை செய்
மறித்தல் என்பதன் பொருள் இறத்தல்	மரித்தல் என்பதன் பொருள் இறத்தல்
மறித்தல் என்பதன் பொருள் சாதல்	மரித்தல் என்பதன் பொருள் சாதல்
மரித்தல் என்பதன் பொருள் தடுத்தல்	மறித்தல் என்பதன் பொருள் தடுத்தல்
மரித்தல் என்பதன் பொருள் திரும்புதல்	மறித்தல் என்பதன் பொருள் திரும்புதல்
மரித்தல் என்பதன் பொருள் அழித்தல்	மறித்தல் என்பதன் பொருள் அழித்தல்
மறை என்பதன் பொருள் மான்	மரை என்பதன் பொருள் மான்
மரை என்பதன் பொருள் வேதம்	மறை என்பதன் பொருள் வேதம்
மறு என்பதன் பொருள் மலை	மரு என்பதன் பொருள் மலை
மறு என்பதன் பொருள் பாலை நிலம்	மரு என்பதன் பொருள் பாலை நிலம்
மறு என்பதன் பொருள் மண விருந்து	மரு என்பதன் பொருள் மண விருந்து
மறு என்பதன் பொருள் நீரில்லா இடம்	மரு என்பதன் பொருள் நீரில்லா இடம்
மறு என்பதன் பொருள் மருக்கொழுந்து	மரு என்பதன் பொருள் மருக்கொழுந்து
மரு என்பதன் பொருள் குற்றம்	மறு என்பதன் பொருள் குற்றம்
மரு என்பதன் பொருள் மச்சம்	மறு என்பதன் பொருள் மச்சம்
மரு என்பதன் பொருள் எதிர்	மறு என்பதன் பொருள் எதிர்
மரு என்பதன் பொருள் வேறு	மறு என்பதன் பொருள் வேறு
மரு என்பதன் பொருள் அடையாளம்	மறு என்பதன் பொருள் அடையாளம்
மறுப்பு என்பதன் பொருள் கொம்பு	மருப்பு என்பதன் பொருள் கொம்பு
மறுப்பு என்பதன் பொருள் யானைத் தந்தம்	மருப்பு என்பதன் பொருள் யானைத் தந்தம்
மறுப்பு என்பதன் பொருள் யாழ்த் தண்டு	மருப்பு என்பதன் பொருள் யாழ்த் தண்டு
மருப்பு என்பதன் பொருள் எதிர்ப்பு	மறுப்பு என்பதன் பொருள் எதிர்ப்பு
மறுகு என்பதன் பொருள் வாசனைத் தாவரம்	மருகு என்பதன் பொருள் வாசனைத் தாவரம்
மருகு என்பதன் பொருள் சிறியதெரு	மறுகு என்பதன் பொருள் சிறியதெரு
மாறன் என்பதன் பொருள் மன்மதன்	மாரன் என்பதன் பொருள் மன்மதன்
மாறன் என்பதன் பொருள் காமன்	மாரன் என்பதன் பொருள் காமன்
மாரன் என்பதன் பொருள் பாண்டியன்	மாறன் என்பதன் பொருள் பாண்டியன்
மாரன் என்பதன் பொருள் சடகோபாழ்வார்	மாறன் என்பதன் பொருள் சடகோபாழ்வார்
முறி என்பதன் பொருள் பாலை நிலம்	முரி என்பதன் பொருள் பாலை நிலம்
முறி என்பதன் பொருள் நொய்	முரி என்பதன் பொருள் நொய்
முறி என்பதன் பொருள் சிதைவு	முரி என்பதன் பொருள் சிதைவு
முரி என்பதன் பொருள் ஒடி	முறி என்பதன் பொருள் ஒடி
முரி என்பதன் பொருள் பத்திரம்	முறி என்பதன் பொருள் பத்திரம்
முரி என்பதன் பொருள் தளிர்	முறி என்பதன் பொருள் தளிர்
முரி என்பதன் பொருள் எழுது	முறி என்பதன் பொருள் எழுது
முரி என்பதன் பொருள் துண்டு	முறி என்பதன் பொருள் துண்டு
முறுக்குதல் என்பதன் பொருள் அழித்தல்	முருக்குதல் என்பதன் பொருள் அழித்தல்
முறுக்குதல் என்பதன் பொருள் உருக்குதல்	முருக்குதல் என்பதன் பொருள் உருக்குதல்
முருக்குதல் என்பதன் பொருள் சுழற்றுதல்	முறுக்குதல் என்பதன் பொருள் சுழற்றுதல்
முருக்குதல் என்பதன் பொருள் திரித்தல்	முறுக்குதல் என்பதன் பொருள் திரித்தல்
வறம் என்பதன் பொருள் இறைவன் கொடுப்பது	வரம் என்பதன் பொருள் இறைவன் கொடுப்பது
வறம் என்பதன் பொருள் வேண்டும் பொருள்	வரம் என்பதன் பொருள் வேண்டும் பொருள்
வறம் என்பதன் பொருள் தெய்வ ஈகை	வரம் என்பதன் பொருள் தெய்வ ஈகை
வறம் என்பதன் பொருள் மேன்மை	வரம் என்பதன் பொருள் மேன்மை
வறம் என்பதன் பொருள் விருப்பம்	வரம் என்பதன் பொருள் விருப்பம்
வரம் என்பதன் பொருள் வற்றுதல்	வறம் என்பதன் பொருள் வற்றுதல்
வரம் என்பதன் பொருள் வறட்சி	வறம் என்பதன் பொருள் வறட்சி
வரம் என்பதன் பொருள் பஞ்சம்	வறம் என்பதன் பொருள் பஞ்சம்
வரம் என்பதன் பொருள் நீரின்மை	வறம் என்பதன் பொருள் நீரின்மை
வரம் என்பதன் பொருள் வறுமை	வறம் என்பதன் பொருள் வறுமை
வரம் என்பதன் பொருள் வெம்மை	வறம் என்பதன் பொருள் வெம்மை
வறவு என்பதன் பொருள் வருமானம்	வரவு என்பதன் பொருள் வருமானம்
வறவு என்பதன் பொருள் வழி	வரவு என்பதன் பொருள் வழி
வரவு என்பதன் பொருள் கஞ்சி	வறவு என்பதன் பொருள் கஞ்சி
வறப்பு என்பதன் பொருள் எல்லை	வரப்பு என்பதன் பொருள் எல்லை
வறப்பு என்பதன் பொருள் வரம்பு	வரப்பு என்பதன் பொருள் வரம்பு
வரப்பு என்பதன் பொருள் வறட்சி	வறப்பு என்பதன் பொருள் வறட்சி
வரப்பு என்பதன் பொருள் வறுமை	வறப்பு என்பதன் பொருள் வறுமை
வரப்பு என்பதன் பொருள் வற்றுதல்	வறப்பு என்பதன் பொருள் வற்றுதல்
விறகு என்பதன் பொருள் விவேகம்	விரகு என்பதன் பொருள் விவேகம்
விறகு என்பதன் பொருள் உபாயம்	விரகு என்பதன் பொருள் உபாயம்
விறகு என்பதன் பொருள் உற்சாகம்	விரகு என்பதன் பொருள் உற்சாகம்
விறகு என்பதன் பொருள் புத்தி	விரகு என்பதன் பொருள் புத்தி
விறகு என்பதன் பொருள் கபடம்	விரகு என்பதன் பொருள் கபடம்
விரகு என்பதன் பொருள் எரிகட்டை	விறகு என்பதன் பொருள் எரிகட்டை
விறலி என்பதன் பொருள் மஞ்சள்	விரலி என்பதன் பொருள் மஞ்சள்
விரலி என்பதன் பொருள் மெய்ப்பாடு தோன்ற ஆடிப்பாடும் பெண்	விறலி என்பதன் பொருள் மெய்ப்பாடு தோன்ற ஆடிப்பாடும் பெண்
விரலி என்பதன் பொருள் பதினாறு வயதினள்	விறலி என்பதன் பொருள் பதினாறு வயதினள்
விறல் என்பதன் பொருள் மனித உடலில் உள்ள உறுப்பு	விரல் என்பதன் பொருள் மனித உடலில் உள்ள உறுப்பு
விரல் என்பதன் பொருள் பெருமை	விறல் என்பதன் பொருள் பெருமை
விரல் என்பதன் பொருள் வீரம்	விறல் என்பதன் பொருள் வீரம்
விரல் என்பதன் பொருள் வெற்றி	விறல் என்பதன் பொருள் வெற்றி
விரல் என்பதன் பொருள் மிகுதி	விறல் என்பதன் பொருள் மிகுதி
விரல் என்பதன் பொருள் வலி	விறல் என்பதன் பொருள் வலி
விறாய் என்பதன் பொருள் விறகு	விராய் என்பதன் பொருள் விறகு
விராய் என்பதன் பொருள் செருக்கு	விறாய் என்பதன் பொருள் செருக்கு
விராய் என்பதன் பொருள் இறுமாப்பு	விறாய் என்பதன் பொருள் இறுமாப்பு
வெறு என்பதன் பொருள் அச்சம்	வெரு என்பதன் பொருள் அச்சம்
வெரு என்பதன் பொருள் வெறுத்து விடு	வெறு என்பதன் பொருள் வெறுத்து விடு
வெறல் என்பதன் பொருள் மூங்கில்	வெரல் என்பதன் பொருள் மூங்கில்
வெரல் என்பதன் பொருள் வெல்லுதல்	வெறல் என்பதன் பொருள் வெல்லுதல்
வெரல் என்பதன் பொருள் வெற்றி கொள்ளல்	வெறல் என்பதன் பொருள் வெற்றி கொள்ளல்
விறை என்பதன் பொருள் விரைந்து செல்	விரை என்பதன் பொருள் விரைந்து செல்
விரை என்பதன் பொருள் மரத்துப் போதல்	விறை என்பதன் பொருள் மரத்துப் போதல்